</s>	sil
<s>	sil
SIL-ENCE	sil
[s]	nse
a	E
aafrika	a a f r i k a
abantu	a b a n t_> u
abantwana	a b a n t_> w a n a
abba	a b b a
abya	a bj a
abyi	a bj i
abyingari	a bj i N g a r i
abyinge	a bj i N g E
abyiri	a bj i r i
academy	a tS_> a d E m
academy	E k a d E m i
access	a k s E s
access	a tS_> tS_> E s s
achina	a tS_h i n a
acid	a s E d
acid	a tS_> i d
actors	a k t_> E z
actors	a tS_> t_> O r s
adirese	a d i r E s E
advance	a d B a n tS_> E
advance	E d v a n s
adya	a dj a
afika	a f i k a
africa	a f r i k E
africa	a f r i tS_> a
africadzonga	a f r i tS_> a dz` O N g a
african	a f r i k E n
african	a f r i tS_> a n
afrika	a f r i k a
afrikadzoga	a f r i k a dz` O g a
afrikadzonga	a f r i k a dz` O N g a
afrikha	a f r i k_h a
aftermath	a f t_> E m a f
aftermath	a f t_> E r m a t_h
agibite	a g i b i t_> E
agreement	a g r E E m E n t_>
agreement	E g r i m E n t_>
agreements	a g r E E m E n tS_>
agreements	E g r i m E n t_> s
ahi	a h\ i
ahihi	a h\ i h\ i
ahitivaneni	a h\ i t_> i B a n E n i
ahiye	a h\ i j E
ahluriwe	a K u r i w E
aids	a i d s
aids	E d z
air	a i r
air	E r
ajet	a d_0Z E t_>
ajoni	a d_0Z O n i
aka	a k a
akadli	a k a dK i
akahari	a k a h\ a r i
akamiri	a k a m i r i
akani	a k a n i
akeka	a k E k a
akeki	a k E k i
akela	a k E l a
akeriwa	a k E r i w a
akhademiya	a k_h a d E m i j a
akhawunti	a k_h a w u n t_> i
aki	a k i
akiwa	a k i w a
akiwi	a k i w i
akiwile	a k i w i l E
aku	a k u
akufanele	a k u f a n E l E
akuna	a k u n a
akuri	a k u r i
akuuri	a k u u r i
ala	a l a
alava	a l a B a
ali	a l i
alo	a l O
ama	a m a
amahleni	a m a K E n i
amakhotsweni	a m a k_h O tS_> w E n i
amalimi	a m a l i m i
amandebele	a m a n d E b E l E
amanengi	a m a n E N g i
amapfuna	a m a p f u n a
amarhabha	a m a rh\ a b a
amasiko	a m a s i k O
ambala	a m b a l a
ambalagaweni	a m b a l a g a w E n i
ambale	a m b a l E
ambalo	a m b a l O
ambarhiwa	a m b a rh\ i w a
ambarile	a m b a r i l E
ambariwa	a m b a r i w a
ambexiwa	a m b E S i w a
america	a m E r i tS_> a
america	E m E r i k E
american	a m E r i tS_> a n
american	E m E r i k E n
amirini	a m i r i n i
amu	a m u
amukela	a m u k E l a
amukeleka	a m u k E l E k a
amukelekabyi	a m u k E l E k a bj i
amukelekaka	a m u k E l E k a k a
amukelekeke	a m u k E l E k E k E
amukeleki	a m u k E l E k i
amukelekile	a m u k E l E k i l E
amukeli	a m u k E l i
amukerhiwa	a m u k E rh\ i w a
amukerile	a m u k E r i l E
amukeriwa	a m u k E r i w a
amukeriwaka	a m u k E r i w a k a
amukeriweke	a m u k E r i w E k E
amukeriwile	a m u k E r i w i l E
amusambiki	a m u s a m b i k i
an	a n
ana	a n a
anakanya	a n a k a J a
anama	a n a m a
anamile	a n a m i l E
anamisa	a n a m i s a
ananmile	a n a n m i l E
anc	a n tS_>
anc	E E n s i
andlala	a n dK a l a
andlalaka	a n dK a l a k a
andlariwa	a n dK a r i w a
andlariwangi	a n dK a r i w a N g i
andlariwe	a n dK a r i w E
andlariweke	a n dK a r i w E k E
andlariwil	a n dK a r i w i l
andlariwile	a n dK a r i w i l E
andza	a n' dz` a
andzi	a n' dz` i
andzile	a n' dz` i l E
andziri	a n' dz` i r i
andzisa	a n' dz` i s a
andzisiweke	a n' dz` i s i w E k E
aneka	a n E k a
anga	a N g a
angandli	a N g a n dK i
angarhela	a N g a rh\ E l a
angasi	a N g a s i
angayitsala	a N g a j i tS_> a l a
ange	a N g E
anhakini	a n_h a k i n i
antswa	a n tS_> w a
antsweriwa	a n tS_> w E r i w a
antswisa	a n tS_> w i s a
antswisiwa	a n tS_> w i s i w a
apila	a p i l a
area	a r E a
area	E r E
ari	a r i
arihhosi	a r i h\ h\ O s i
arikhotsweni	a r i k_h O tS_> w E n i
arina	a r i n a
arinavavasati	a r i n a B a B a s a t_> i
arini	a r i n i
ariwile	a r i w i l E
army	a m i
army	a r m
art	a r t_>
art	a t_>
arts	a r tS_>
arts	a t_> s
ashirilekavantima	a S i r i l E k a B a n t_> i m a
asian	a s i a n
asian	E d_0Z E n
asiwa	a s i w a
asosiyexini	a s O s i j E S i n i
aswa	a s` a
aswi	a s` i
aswikahle	a s` i k a K E
aswinahlathi	a s` i n a K a t_h i
aswiolovi	a s` i O l O B i
aswita	a s` i t_> a
ataha	a t_> a h\ a
ati	a t_> i
atikweni	a t_> i k w E n i
atina	a t_> i n a
atinga	a t_> i N g a
atiri	a t_> i r i
atirikona	a t_> i r i k O n a
atitalangi	a t_> i t_> a l a N g i
atlantic	a t_> l a n t_> i k
atlantic	a tl_> a n t_> i tS_>
atlantika	a tl_> a n t_> i k a
atshama	a tS_h a m a
australian	a u s t_> r a l i a n
australian	O s t_> r E l E n
author	a u t_h O r
author	O f E r
authority	a u t_h O r i tj
authority	O f O r E t_> i
ava	a B a
avafuma	a B a f u m a
avakarhala	a B a k a rh\ a l a
avalavela	a B a l a B E l a
avanga	a B a N g a
avanyisa	a B a J i s a
avanyisiwa	a B a J i s i w a
avanyisiwile	a B a J i s i w i l E
avatsikilana	a B a tS_> i k i l a n a
avelana	a B E l a n a
averiwa	a B E r i w a
avhareji	a v a r E d_0Z i
aviwa	a B i w a
avu	a B u
avuma	a B u m a
awa	a w a
awaha	a w a h\ a
awara	a w a r a
award	a w a r d
award	E w O d
awo	a w O
awu	a w u
awufani	a w u f a n i
awuna	a w u n a
awuri	a w u r i
awuta	a w u t_> a
axa	a S a
axi	a S i
axilaveka	a S i l a B E k a
aya	a j a
ayafa	a j a f a
ayaha	a j a h\ a
ayahari	a j a h\ a r i
ayari	a j a r i
ayavitiwa	a j a B i t_> i w a
ayazikhakhazisa	a j a z i k_h a k_h a z i s a
ayi	a j i
ayibi	a j i b i
ayimbelela	a j i m b E l E l a
ayina	a j i n a
ayingari	a j i N g a r i
ayini	a j i n i
ayiri	a j i r i
ayirina	a j i r i n a
ayisi	a j i s i
ayiti	a j i t_> i
b	b i
ba	b a
badela	b a d E l a
baji	b a d_0Z i
bakanyela	b_< a k a J E l a
bakwa	b a k w a
baleka	b a l E k a
balekeni	b a l E k E n i
balekile	b a l E k i l E
baloyi	b a l O j i
banana	b a n a n a
banana	b E n a n E
band	b a n d
bandi	b a n d i
bang	b a N
bang	b a N g
bangi	b a N g i
barack	b a r a tS_> k
barack	b a r E k
baragwana	b a r a g w a n a
basa	b_< a s a
baseball	b_< a s E b a l l
baseball	b E s b O l
based	b_< a s E d
based	b E s t_>
bases	b_< a s E s
bases	b E s i z
basikiri	b_< a s i k i r i
basisiwa	b_< a s i s i w a
bava	b a B a
bayawathanda	b a j a w a t_h a n d a
bayisikopo	b a j i s i k O p O
bayisikpo	b a j i s i k p O
bazi	b a z i
beaker	b E a k E r
beaker	b i k E r
bebula	b E b u l a
bebule	b E b u l E
beburiwa	b E b u r i w a
bee	b E E
bee	b i
bela	b E l a
bele	b E l E
beliefs	b E l i E f s
beliefs	b i l i f s
bende	b_< E n d E
beriwa	b E r i w a
besikolo	b E s i k O l O
best	b E s t_>
bhaka	b a k a
bhatji	b a t_> d_0Z i
bhiriviri	b i r i B i r i
bholo	b O l O
bhuku	b u k u
bhuruku	b u r u k u
bibele	b i b E l E
big	b i g
biggest	b i g E s t_>
biggest	b i g g E s t_>
biha	b i h\ a
bihe	b i h\ E
bihile	b i h\ i l E
bile	b a l
bile	b_< i l E
bill	b E l
bill	b_< i l l
biloho	b_< i l O h\ O
bindzu	b_< i n' dz` u
bindzula	b_< i n' dz` u l a
bindzurisa	b_< i n' dz` u r i s a
bindzurisiwa	b_< i n' dz` u r i s i w a
bindzwana	b_< i n' dz` w a n a
biriteni	b i r i t_> E n i
bisa	b_< i s a
biwa	b i w a
biyiwa	b i j i w a
bizi	b i z i
bloc	b l O k
bloc	b l O tS_>
blood	b l a d
blood	b l O O d
bodo	b O d O
boha	b O h\ a
bohaka	b O h\ a k a
bohana	b O h\ a n a
bohanile	b O h\ a n i l E
bohe	b O h\ E
boheka	b O h\ E k a
bohela	b O h\ E l a
bohiwa	b O h\ i w a
bohiwaka	b O h\ i w a k a
bola	b_< O l a
boleriwa	b_< O l E r i w a
boli	b_< O l i
bolo	b_< O l O
bomba	b O m b a
bombiwa	b O m b i w a
bombo	b O m b O
bonga	b_< O N g a
bongo	b O n g O
bongo	b_< O N g O
boniwa	b_< O n i w a
borha	b O rh\ a
borile	b O r i l E
boston	b O s t_> E n
boston	b O s t_> O n
boti	b O t_> i
bowler	b O l E r
bowler	b O w l E r
box	b O k s
box	b_< O S
boxa	b_< O S a
boxani	b_< O S a n i
boxeke	b_< O S E k E
boxeleleka	b_< O S E l E l E k a
boxiwaka	b_< O S i w a k a
boxiweke	b_< O S i w E k E
boxiwile	b_< O S i w i l E
boy	b O
boy	b O j
bra	b r a
brazil	b r a z i l
brazil	b r E z i l
british	b r E t_> i s
british	b r i t_> i S
buba	b_< u b a
buku	b_< u k u
bungeni	b u N g E n i
burhuku	b_< u rh\ u k u
burisana	b_< u r i s a n a
buruku	b u r u k u
bvana	b v a n a
bwamutshayi	b w a m u tS_h a j i
bwanyi	b w a J i
bwatifilimu	b w a t_> i f i l i m u
bwi	b w i
bwifambelana	b w i f a m b E l a n a
bwikatsiwa	b w i k a tS_> i w a
bwikombisa	b w i k O m b i s a
bwilavanto	b w i l a B a n t_> O
bwipfusha	b w i p f u S a
bwosaseka	b w O s a s E k a
bya	bj a
byakereke	bj a k E r E k E
byakwe	bj a k w E
byala	bj a l a
byalaka	bj a l a k a
byali	bj a l i
byalwa	bj a l w a
byalwabya	bj a l w a bj a
byanyi	bj a J i
byariwa	bj a r i w a
byariwi	bj a r i w i
byatso	bj a tS_> O
byela	bj E l a
byele	bj E l E
byi	bj i
byile	bj i l E
byin	bj i n
byini	bj i n i
byinwani	bj i n w a n i
byita	bj i t_> a
byitsongo	bj i tS_> O N g O
byo	bj O
byona	bj O n a
byongo	bj O N g O
c	s i
calibiraxini	tS_> a l i b i r a S i n i
cape	k E p
cape	tS_> a p E
cata	tS_> a t_> a
catholic	k a f l i k
catholic	tS_> a t_h O l i tS_>
catholics	k a f l i k s
catholics	tS_> a t_h O l i tS_> s
cela	tS_> E l a
celani	tS_> E l a n i
cells	s E l z
cells	tS_> E l l s
cema	tS_> E m a
census	s E n s E s
census	tS_> E n s u s
central	s E n t_> r E l
central	tS_> E n t_> r a l
chachula	tS_h a tS_h u l a
chain	tS_h a i n
chain	tS_h E n
chali	tS_h a l i
champions	tS_h a m p E n z
champions	tS_h a m p i O n s
chauke	tS_h a u k E
chava	tS_h a B a
chavani	tS_h a B a n i
chaveki	tS_h a B E k i
chavi	tS_h a B i
chavisa	tS_h a B i s a
chaviwa	tS_h a B i w a
chaya	tS_h a j a
chayahi	tS_h a j a h\ i
chayani	tS_h a j a n i
chayela	tS_h a j E l a
chayeriwa	tS_h a j E r i w a
chayi	tS_h a j i
chayile	tS_h a j i l E
chayisiwa	tS_h a j i s i w a
chayiwa	tS_h a j i w a
chechisa	tS_h E tS_h i s a
cheka	tS_h E k a
chela	tS_h E l a
chelela	tS_h E l E l a
cheleta	tS_h E l E t_> a
cheriwa	tS_h E r i w a
chess	tS_h E s
chess	tS_h E s s
chicha	tS_h i tS_h a
chika	tS_h i k a
chikile	tS_h i k i l E
chikisa	tS_h i k i s a
china	tS_h a n E
china	tS_h i n a
chinese	tS_h a n i z
chinese	tS_h i n E s E
chipa	tS_h i p a
chipe	tS_h i p E
chipile	tS_h i p i l E
chochovela	tS_h O tS_h O B E l a
chongoriwa	tS_h O N g O r i w a
chukele	tS_h u k E l E
chukiwa	tS_h u k i w a
chuluka	tS_h u l u k a
church	tS_h a tS_h
church	tS_h u r tS_h
chuvekile	tS_h u B E k i l E
cica	tS_> i tS_> a
cina	tS_> i n a
cinamisa	tS_> i n a m i s a
cinca	tS_> i n tS_> a
cincana	tS_> i n tS_> a n a
cincaniwa	tS_> i n tS_> a n i w a
cincenki	tS_> i n tS_> E n k i
cincile	tS_> i n tS_> i l E
cincisa	tS_> i n tS_> i s a
cinciwa	tS_> i n tS_> i w a
cinciwi	tS_> i n tS_> i w i
cinciwile	tS_> i n tS_> i w i l E
cineka	tS_> i n E k a
cinela	tS_> i n E l a
cini	tS_> i n i
cinisa	tS_> i n i s a
ciniwa	tS_> i n i w a
ciniweni	tS_> i n i w E n i
ciniwi	tS_> i n i w i
citric	s i t_> r i k
citric	tS_> i t_> r i tS_>
classic	k l a s i k
classic	tS_> l a s s i tS_>
classical	k l a s i k E l
classical	tS_> l a s s i tS_> a l
classification	k l a s i f i k E s E n
classification	tS_> l a s s i f i tS_> a t_> i O n
climate	k l a m E t_>
climate	tS_> l i m a t_> E
clouds	k l a d z
clouds	tS_> l O u d s
cold	k O l d
cold	tS_> O l d
college	k O l i d_0Z
college	tS_> O l l E g E
command	k E m a n d
command	tS_> O m m a n d
communist	k O m j u n E s t_>
communist	tS_> O m m u n i s t_>
company	k a m p E n i
company	tS_> O m p a J
conference	k O n f E r E n s
conference	tS_> O n f E r E n tS_> E
congo	k O N g O
congo	tS_> O N g O
congress	k O N g r E s
congress	tS_> O N g r E s s
council	k a n s E l
council	tS_> O u n tS_> i l
countries	k a n t_> r i z
countries	tS_> O u n t_> r i E s
coup	k u
coup	tS_> O u p
court	k O t_>
court	tS_> O u r t_>
cpix	s i p i a E k s
cultural	k a l tS_h E r E l
cultural	tS_> u l t_> u r a l
culture	k a l tS_h E r
culture	tS_> u l t_> u r E
cup	k a p
cup	tS_> u p
cycle	s a k E l
cycle	tS_> tS_> l E
d	d i
da	d a
damu	d a m u
dangari	d a N g a r i
dankisa	d a n k i s a
date	d a t_> E
date	d E t_>
davuko	d a B u k O
davula	d a B u l a
debyisile	d E bj i s i l E
deeds	d E E d s
deeds	d i d z
delela	d E l E l a
democratic	d E m E k r a t_> i k
democratic	d E m O tS_> r a t_> i tS_>
designers	d E s i g n E r s
designers	d i z a n E z
development	d E B E l O p m E n t_>
development	d i v E l E p m E n t_>
dholara	dh\ O l a r a
different	d E f r E n t_>
different	d i f f E r E n t_>
dikixini	d i k i S i n i
dilika	d i l i k a
dini	d i n i
director	d i r E k t_> E r
director	d i r E tS_> t_> O r
dirowa	d i r O w a
divhayisi	d i v a j i s i
dlawa	dK a w a
dlaya	dK a j a
dlaye	dK a j E
dlayela	dK a j E l a
dlayelana	dK a j E l a n a
dlayiwa	dK a j i w a
dlilosari	dK i l O s a r i
dlula	dK u l a
dogisi	d O g i s i
dokete	d O k E t_> E
dokodela	d O k O d E l a
dokoltela	d O k O l t_> E l a
dokumende	d O k u m E n d E
dolara	d O l a r a
doroba	d O r O b a
dorobankulu	d O r O b a n k u l u
dplg	d i p i a l d_0Z i
dsp	d i E s p i
duku	d u k u
dulu	d u l u
duma	d u m a
dumakule	d u m a k u l E
dumile	d u m i l E
dura	d u r a
durha	d u rh\ a
durheliwa	d u rh\ E l i w a
dutch	d a tS_h
dutch	d u t_> tS_h
duvula	d u B u l a
duvulana	d u B u l a n a
dwaf	d i d a b E l j u E E f
dwaf	d w a f
dya	dj a
dyambu	dj a m b u
dyana	dj a n a
dyandza	dj a n' dz` a
dyayiwa	dj a j i w a
dyeka	dj E k a
dyela	dj E l a
dyeriwa	dj E r i w a
dyi	dj i
dyile	dj i l E
dyindaka	dj i n d a k a
dyindzo	dj i n' dz` O
dyisa	dj i s a
dyiwa	dj i w a
dyondo	dj O n d O
dyondza	dj O n' dz` a
dyondzaku	dj O n' dz` a k u
dyondzekaku	dj O n' dz` E k a k u
dyondzeke	dj O n' dz` E k E
dyondzekile	dj O n' dz` E k i l E
dyondzela	dj O n' dz` E l a
dyondzeriwa	dj O n' dz` E r i w a
dyondzi	dj O n' dz` i
dyondzile	dj O n' dz` i l E
dyondzisa	dj O n' dz` i s a
dyondzisamahanyelo	dj O n' dz` i s a m a h\ a J E l O
dyondzisi	dj O n' dz` i s i
dyondzisiwa	dj O n' dz` i s i w a
dyondziwa	dj O n' dz` i w a
dyondzo	dj O n' dz` O
dzaheki	dz` a h\ E k i
dzahisani	dz` a h\ i s a n i
dzimana	dz` i m a n a
dzimile	dz` i m i l E
dzinda	dz` i n d a
dzindza	dz` i n' dz` a
dzivamisoko	dz` i B a m i s O k O
dzivamusoko	dz` i B a m u s O k O
dzonga	dz` O N g a
dzongeni	dz` O N g E n i
dzovo	dz` O B O
dzumba	dz` u m b a
dzumbauya	dz` u m b a u j a
dzumeri	dz` u m E r i
dzunga	dz` u N g a
e	i
eafrika	E a f r i k a
east	E a s t_>
east	i s t_>
eastern	E a s t_> E r n
eastern	i s t_> E n
easy	E a s
easy	i z i
ebakweni	E b a k w E n i
ebalulekileko	E b a l u l E k i l E k O
ebandla	E b a n dK a
ebangi	E b a N g i
ebindzwini	E b i n' dz` w i n i
ebolweni	E b O l w E n i
ebukwini	E b_< u k w i n i
ebyalweni	E bj a l w E n i
economic	E tS_> O n O m i tS_>
economic	i k E n O m i k
economy	E tS_> O n O m
economy	i k O n E m i
edorobeni	E d O r O b E n i
edyambini	E dj a m b i n i
edyambyini	E dj a m bj i n i
edzongeni	E dz` O N g E n i
egandzweleni	E g a n' dz` w E l E n i
egiyani	E g i j a n i
egondzweni	E g O n' dz` w E n i
ehandle	E h\ a n dK E
ehansi	E h\ a n s i
ehasi	E h\ a s i
ehehla	E h\ E K a
ehenhla	E h\ E n K a
ehleketa	E K E k E t_> a
ehleketangi	E K E k E t_> a N g i
ehleketisisa	E K E k E t_> i s i s a
ehleketiweke	E K E k E t_> i w E k E
eholweni	E h\ O l w E n i
ehubyeni	E h\ u bj E n i
eitjha	E i t_> dZh\ a
ejoni	E d_0Z O n i
eka	E k a
ekabholo	E k a b O l O
ekabhuku	E k a b u k u
ekafilimu	E k a f i l i m u
ekaku	E k a k u
ekamabindzu	E k a m a b i n' dz` u
ekankhuvolowu	E k a n k_h u B O l O w u
ekanwe	E k a n w E
ekapa	E k a p a
ekatandzavuko	E k a t_> a n' dz` a B u k O
ekatashintu	E k a t_> a S i n t_> u
ekathelevishini	E k a t_h E l E B i S i n i
ekatibhuku	E k a t_> i b u k u
ekatifilimu	E k a t_> i f i l i m u
ekatimale	E k a t_> i m a l E
ekavafana	E k a B a f a n a
ekavumundzuku	E k a B u m u n' dz` u k u
ekavutivi	E k a B u t_> i B i
ekaxitori	E k a S i t_> O r i
ekaya	E k a j a
eke	E k
eke	E k E
ekerekeni	E k E r E k E n i
ekeya	E k E j a
ekhoto	E k_h O t_> O
ekhotsweni	E k_h O tS_> w E n i
eku	E k u
ekule	E k u l E
ekusuhi	E k u s u h\ i
elawini	E l a w i n i
elayiburari	E l a j i b u r a r i
election	E l E tS_> t_> i O n
election	i l E k s E n
elections	E l E tS_> t_> i O n s
elections	i l E k s E n z
elekitroniki	E l E k i t_> r O n i k i
elembeni	E l E m b E n i
elim	E l i m
elima	E l i m a
elwandle	E l w a n dK E
ema	E m a
emabindzwini	E m a b i n' dz` w i n i
emadorobeni	E m a d O r O b E n i
emahlweni	E m a K w E n i
emakaya	E m a k a j a
emakhwayeni	E m a k_h w a j E n i
emakixini	E m a k i S i n i
emakumu	E m a k u m u
emalokixi	E m a l O k i S i
emananga	E m a n a N g a
emapatwini	E m a p a t_> w i n i
emapurasini	E m a p u r a s i n i
emarhumbini	E m a rh\ u m b i n i
emasinwini	E m a s i n w i n i
emasirheni	E m a s i rh\ E n i
ematiko	E m a t_> i k O
ematikwena	E m a t_> i k w E n a
ematikweni	E m a t_> i k w E n i
ematini	E m a t_> i n i
ematsalweni	E m a tS_> a l w E n i
emavhengeleni	E m a v E N g E l E n i
embasi	E m b_< a s i
embilwini	E m b i l w i n i
emhakeni	E m_h a k E n i
emicatwini	E m i tS_> a t_> w i n i
emiehleketweni	E m i E K E k E t_> w E n i
emihle	E m i K E
emikubyeni	E m i k u bj E n i
emindyangwini	E m i n dj a N g w i n i
eminkosini	E m i n k O s i n i
eminsinyeni	E m i n s i J E n i
emintirhweni	E m i n t_> i rh\ w E n i
emintlangwini	E m i n tl_> a N g w i n i
emintlongwini	E m i n tl_> O N g w i n i
eminyanyeni	E m i J a J E n i
emirhini	E m i rh\ i n i
emirini	E m i r i n i
emisaveni	E m i s a B E n i
emisinyeni	E m i s i J E n i
emitini	E m i t_> i n i
emovheni	E m O v E n i
emoyeni	E m O j E n i
empire	E m p a E r
empire	E m p i r E
emugangeni	E m u g a N g E n i
emugodini	E m u g O d i n i
emutini	E m u t_> i n i
ena	E n a
enambyeni	E n a m bj E n i
enawini	E n a w i n i
encenyeta	E n tS_> E J E t_> a
encuveni	E n tS_> u B E n i
endhawina	E n dh\ a w i n a
endhawini	E n dh\ a w i n i
endla	E n dK a
endlaka	E n dK a k a
endlaku	E n dK a k u
endlangi	E n dK a N g i
endle	E n dK E
endleka	E n dK E k a
endlekaka	E n dK E k a k a
endleke	E n dK E k E
endleki	E n dK E k i
endlela	E n dK E l a
endlele	E n dK E l E
endleleni	E n dK E l E n i
endlelo	E n dK E l O
endleriwa	E n dK E r i w a
endleriwaka	E n dK E r i w a k a
endleriwe	E n dK E r i w E
endli	E n dK i
endlisa	E n dK i s a
endliwa	E n dK i w a
endliwahi	E n dK i w a h\ i
endliwaka	E n dK i w a k a
endliweke	E n dK i w E k E
endliweni	E n dK i w E n i
endliwile	E n dK i w i l E
endlwini	E n dK w i n i
endyangu	E n dj a N g u
endzambyana	E n' dz` a m bj a n a
endzela	E n' dz` E l a
endzeni	E n' dz` E n i
endzeriwa	E n' dz` E r i w a
endzhaklu	E n' dz`h\ a k l u
endzhaku	E n' dz`h\ a k u
endzilweni	E n' dz` i l w E n i
endzimaneni	E n' dz` i m a n E n i
ene	E n E
eneji	E n E d_0Z i
enela	E n E l a
enelangi	E n E l a N g i
enelanyana	E n E l a J a n a
enengeni	E n E N g E n i
enerisa	E n E r i s a
enerisaka	E n E r i s a k a
enerisaku	E n E r i s a k u
enerisi	E n E r i s i
enerisiwa	E n E r i s i w a
enerisiwi	E n E r i s i w i
engetela	E N g E t_> E l a
engetelela	E N g E t_> E l E l a
engeteriwa	E N g E t_> E r i w a
engeteriwe	E N g E t_> E r i w E
engeteriweke	E N g E t_> E r i w E k E
engomeni	E N g O m E n i
enhlangasini	E n K a N g a s i n i
enhlokweni	E n K O k w E n i
enhoveni	E n_h O B E n i
enkhubyeni	E n k_h u bj E n i
enkosini	E n k O s i n i
enkoveni	E n k O B E n i
enkowankowa	E n k O w a n k O w a
enldiwa	E n l d i w a
enonwini	E n O n w i n i
ensenyatsini	E n s E J a tS_> i n i
ensinwini	E n s i n w i n i
ensinyeni	E n s i J E n i
enta	E n t_> a
entalwini	E n t_> a l w i n i
entangeni	E n t_> a N g E n i
entangheni	E n t_> a N gh\ E n i
entile	E n t_> i l E
entirhweni	E n t_> i rh\ w E n i
entlangeni	E n tl_> a N g E n i
entlangwini	E n tl_> a N g w i n i
entshaveni	E n tS_h a B E n i
entshungwini	E n tS_h u N g w i n i
entsungeni	E n tS_> u N g E n i
enwalungu	E n w a l u N g u
enwetini	E n w E t_> i n i
enza	E n' z a
epatwini	E p a t_> w i n i
ephatini	E p_h a t_> i n i
epitori	E p i t_> O r i
era	E r a
era	E r E
eribuweni	E r i b u w E n i
eriendzweni	E r i E n' dz` w E n i
erihhanywini	E r i h\ h\ a J w i n i
eritavi	E r i t_> a B i
erivaleni	E r i B a l E n i
esewula	E s E w u l a
esikweni	E s i k w E n i
eswikolweni	E s` i k O l w E n i
eswitandini	E s` i t_> a n d i n i
eswitolo	E s` i t_> O l O
etambheni	E t_> a m b E n i
etendeni	E t_> E n d E n i
etibhukuwini	E t_> i b u k u w i n i
etibukwini	E t_> i b u k w i n i
etikweni	E t_> i k w E n i
etilweni	E t_> i l w E n i
etindhawini	E t_> i n dh\ a w i n i
etindleveni	E t_> i n dK E B E n i
etintshaveni	E t_> i n tS_h a B E n i
etlela	E tl_> E l a
etlhelo	E tl_h E l O
etlilasini	E tl_> i l a s i n i
etsalweni	E tS_> a l w E n i
etshungeni	E tS_h u N g E n i
etsungeni	E tS_> u N g E n i
eu	E u
eu	i j u
europe	E u r O p E
europe	j O r E p
eveleni	E B E l E n i
evengeleni	E B E N g E l E n i
everest	E B E r E s t_>
evhikini	E v i k i n i
evukatini	E B u k a t_> i n i
evusikwini	E B u s i k w i n i
evuton	E B u t_> O n
evutonwini	E B u t_> O n w i n i
evuxeni	E B u S E n i
exi	E S i
exibedele	E S i b E d E l E
exibedhlele	E S i b E dK\ E l E
exibedlhele	E S i b E dK\ E l E
exikandzeni	E S i k a n' dz` E n i
exikarhi	E S i k a rh\ i
exikari	E S i k a r i
exikolweni	E S i k O l w E n i
exilungwini	E S i l u N g w i n i
exineneni	E S i n E n E n i
exiseveseveni	E S i s E B E s E B E n i
exitangeni	E S i t_> a N g E n i
exitarateni	E S i t_> a r a t_> E n i
exitlhavelwenombe	E S i tl_h a B E l w E n O m b E
exitorini	E S i t_> O r i n i
exitudiyo	E S i t_> u d i j O
exitulwini	E S i t_> u l w i n i
ezimbabwe	E z i m b a b w E
fa	f a
fact	f a k t_>
fact	f a tS_> t_>
fal	f a l
famba	f a m b a
fambaka	f a m b a k a
fambe	f a m b E
fambeki	f a m b E k i
fambela	f a m b E l a
fambelana	f a m b E l a n a
fambelanaka	f a m b E l a n a k a
fambelani	f a m b E l a n i
fambelena	f a m b E l E n a
famberiwa	f a m b E r i w a
fambi	f a m b i
fambisa	f a m b i s a
fambisana	f a m b i s a n a
fambisanaku	f a m b i s a n a k u
fambiselo	f a m b i s E l O
fambisiwa	f a m b i s i w a
famna	f a m n a
famous	f a m O u s
famous	f E m E s
fana	f a n a
fane	f a n E
fanekele	f a n E k E l E
fanela	f a n E l a
fanelanga	f a n E l a N g a
fanelangi	f a n E l a N g i
fanele	f a n E l E
faneleka	f a n E l E k a
faneleke	f a n E l E k E
fanerile	f a n E r i l E
fans	f a n s
fans	f a n z
fantasy	f a n t_> a s
fantasy	f a n t_> E s i
fanyana	f a J a n a
fashini	f a S i n i
fayetela	f a j E t_> E l a
fc	E f s i
fc	f tS_>
february	f E b j O r i
february	f E b r O r i
february	f E b r u a r
fekisi	f E k i s i
fela	f E l a
festivals	f E s t_> E v E l z
festivals	f E s t_> i B a l s
fethela	f E t_h E l a
fexeni	f E S E n i
feyila	f E j i l a
feyisi	f E j i s i
fi	f i
fiction	f i k s E n
fiction	f i tS_> t_> i O n
fifa	f i f a
fihla	f i K a
fihle	f i K E
fika	f i k a
fikaka	f i k a k a
fikela	f i k E l a
fikelela	f i k E l E l a
fikelelangi	f i k E l E l a N g i
fikeleli	f i k E l E l i
fikelerile	f i k E l E r i l E
fikeleriweke	f i k E l E r i w E k E
fikile	f i k i l E
fikixini	f i k i S i n i
file	f a l
file	f i l E
filimi	f i l i m i
filimu	f i l i m u
final	f a n E l
final	f i n a l
finance	f a n a n s
finance	f i n a n tS_> E
firha	f i rh\ a
first	f a s t_>
first	f i r s t_>
fiwa	f i w a
flat	f l a t_>
folela	f O l E l a
foma	f O m a
fomati	f O m a t_> i
fomo	f O m O
fonto	f O n t_> O
football	f O O t_> b a l l
football	f u t_> b O l
for	f O r
foramu	f O r a m u
force	f O r tS_> E
force	f O s
forces	f O r tS_> E s
forces	f O s E s
formed	f O m d
formed	f O r m E d
foyini	f O j i n i
free	f r E E
free	f r i
fukundzani	f u k u n' dz` a n i
fukuzana	f u k u z a n a
fulawuri	f u l a w u r i
fuleleni	f u l E l E n i
fuleriwa	f u l E r i w a
fuma	f u m a
fumbarhela	f u m b a rh\ E l a
fumi	f u m i
fumile	f u m i l E
fumisa	f u m i s a
fumiwile	f u m i w i l E
fumo	f u m O
fumu	f u m u
fundza	f u n' dz` a
fungha	f u N gh\ a
funghiwa	f u N gh\ i w a
fuwe	f u w E
gama	g a m a
gamboko	g a m b O k O
game	g a m E
game	g E m
garingeta	g a r i N g E t_> a
gasa	g a s a
gates	g a t_> E s
gates	g E t_> s
gauteng	g a u t_> E N g
gavaza	g a B a z a
gavele	g a B E l E
gaza	g a z a
gazankula	g a z a n k u l a
gazankulu	g a z a n k u l u
gazete	g a z E t_> E
gazette	g a z E t_> t_> E
gazette	g E z E t_>
gega	g E g a
gembula	g E m b u l a
gems	d_0Z m z
gems	g E m s
german	d_0Z a m E n
german	g E r m a n
gezani	g E z a n i
gezi	g E z i
ghaweni	gh\ a w E n i
ghezi	gh\ E z i
ghobodo	gh\ O b_< O d O
gholufu	gh\ O l u f u
giramugomoyile	g i r a m u g O m O j i l E
giredi	g i r E d i
gireyidi	g i r E j i d i
giridi	g i r i d i
giya	g i j a
glosari	g l O s a r i
goberiwa	g O b_< E r i w a
golofu	g O l O f u
gomolana	g O m O l a n a
gondzo	g O n' dz` O
gonekeke	g O n E k E k E
gongomelai	g O N g O m E l a i
gonya	g O J a
gonyile	g O J i l E
gqweta	g !\ w E t_> a
graphical	g r a f i k E l
graphical	g r a p_h i tS_> a l
gross	g r O s
gross	g r O s s
growth	g r O f
growth	g r O w t_h
gutitimela	g u t_> i t_> i m E l a
gwitsi	g w i tS_> i
gym	d_0Z E m
gym	g m
h	E tS_h
ha	h\ a
hafu	h\ a f u
hahani	h\ a h\ a n i
hakela	h\ a k E l a
hakelaka	h\ a k E l a k a
hakeleriwa	h\ a k E l E r i w a
hakeleriwaka	h\ a k E l E r i w a k a
hakelo	h\ a k E l O
hakerhiwa	h\ a k E rh\ i w a
hakerile	h\ a k E r i l E
hakerisiwa	h\ a k E r i s i w a
hakeriwa	h\ a k E r i w a
hakeriwaka	h\ a k E r i w a k a
hakeriweke	h\ a k E r i w E k E
hakeriwi	h\ a k E r i w i
hakeriwile	h\ a k E r i w i l E
hakona	h\ a k O n a
hakunene	h\ a k u n E n E
hala	h\ a l a
halaka	h\ a l a k a
halakile	h\ a l a k i l E
haleni	h\ a l E n i
haleriwa	h\ a l E r i w a
hamarisa	h\ a m a r i s a
hambana	h\ a m b a n a
hambanahambana	h\ a m b a n a h\ a m b a n a
hambanana	h\ a m b a n a n a
hambanile	h\ a m b a n i l E
hambanisa	h\ a m b a n i s a
hambanyisa	h\ a m b a J i s a
hambekelweni	h\ a m b E k E l w E n i
hambi	h\ a m b i
hambileswi	h\ a m b i l E s` i
hambiloko	h\ a m b i l O k O
hanci	h\ a n tS_> i
handle	h\ a n d E l
handle	h\ a n dK E
handzuka	h\ a n' dz` u k a
hangalasa	h\ a N g a l a s a
hangalasiwa	h\ a N g a l a s i w a
hansi	h\ a n s i
hantsakanyo	h\ a n tS_> a k a J O
hanya	h\ a J a
hanyaka	h\ a J a k a
hanyela	h\ a J E l a
hanyi	h\ a J i
hanyile	h\ a J i l E
hanyisa	h\ a J i s a
hanyisana	h\ a J i s a n a
hanyiwa	h\ a J i w a
hari	h\ a r i
haripa	h\ a r i p a
hasan	h\ a s a n
hasan	h\ E z E n
haseni	h\ a s E n i
hatima	h\ a t_> i m a
hatimela	h\ a t_> i m E l a
hatlisa	h\ a tl_> i s a
hatlisisa	h\ a tl_> i s i s a
hava	h\ a B a
havambirhi	h\ a B a m b i rh\ i
havawakuka	h\ a B a w a k u k a
haveriwa	h\ a B E r i w a
haxa	h\ a S a
haxawa	h\ a S a w a
haxeka	h\ a S E k a
haxiwa	h\ a S i w a
haya	h\ a j a
hayani	h\ a j a n i
hayi	h\ a j i
he	h\ E
he	h\ i
health	h\ E a l t_h
health	h\ E l f
hefemula	h\ E f E m u l a
hefemulaka	h\ E f E m u l a k a
hefemulela	h\ E f E m u l E l a
hehla	h\ E K a
hela	h\ E l a
heleketa	h\ E l E k E t_> a
helela	h\ E l E l a
helelangiku	h\ E l E l a N g i k u
heleleke	h\ E l E l E k E
heleli	h\ E l E l i
heleni	h\ E l E n i
heli	h\ E l i
hemba	h\ E m b a
hembe	h\ E m b E
hembisa	h\ E m b i s a
henhla	h\ E n K a
henhlabyi	h\ E n K a bj i
henhlahenhla	h\ E n K a h\ E n K a
henhlanyana	h\ E n K a J a n a
henhlanyanabyi	h\ E n K a J a n a bj i
herika	h\ E r i k a
heriki	h\ E r i k i
herile	h\ E r i l E
herisa	h\ E r i s a
herisiwa	h\ E r i s i w a
herisiwile	h\ E r i s i w i l E
heta	h\ E t_> a
hetelela	h\ E t_> E l E l a
heti	h\ E t_> i
hetile	h\ E t_> i l E
hetiseka	h\ E t_> i s E k a
hetisisiwa	h\ E t_> i s i s i w a
hhambana	h\ h\ a m b a n a
hhandle	h\ h\ a n dK E
hhasi	h\ h\ a s i
hhavito	h\ h\ a B i t_> O
hhi	h\ h\ i
hhibava	h\ h\ i b a B a
hhija	h\ h\ i d_0Z a
hhijambu	h\ h\ i d_0Z a m b u
hhikuhhisa	h\ h\ i k u h\ h\ i s a
hhikuwa	h\ h\ i k u w a
hhilembe	h\ h\ i l E m b E
hhilwandle	h\ h\ i l w a n dK E
hhimatiko	h\ h\ i m a t_> i k O
hhingwatintshimi	h\ h\ i N g w a t_> i n tS_h i m i
hhintsikelelo	h\ h\ i n tS_> i k E l E l O
hhitashintu	h\ h\ i t_> a S i n t_> u
hhitatelevishini	h\ h\ i t_> a t_> E l E B i S i n i
hhivafana	h\ h\ i B a f a n a
hhivobhasa	h\ h\ i B O b a s a
hhiyona	h\ h\ i j O n a
hholobwe	h\ h\ O l O b w E
hhosi	h\ h\ O s i
hhumelela	h\ h\ u m E l E l a
hhuvo	h\ h\ u B O
hi	h\ a
hi	h\ i
hifanekele	h\ i f a n E k E l E
high	h\ a
high	h\ i gh\
highest	h\ a E s t_>
highest	h\ i gh\ E s t_>
hikokwalaho	h\ i k O k w a l a h\ O
hikomba	h\ i k O m b a
hiku	h\ i k u
hikuva	h\ i k u B a
hikuya	h\ i k u j a
hikwalaho	h\ i k w a l a h\ O
hikwawo	h\ i k w a w O
hikwlaho	h\ i k w l a h\ O
hilaha	h\ i l a h\ a
hile	h\ i l E
hiloko	h\ i l O k O
himhaka	h\ i m_h a k a
himitirho	h\ i m i t_> i rh\ O
hina	h\ i n a
hindzeriweke	h\ i n' dz` E r i w E k E
hinga	h\ i N g a
hingakanya	h\ i N g a k a J a
hingativa	h\ i N g a t_> i B a
hinhlanganisa	h\ i n K a N g a n i s a
hini	h\ i n i
hinkarhi	h\ i n k a rh\ i
hinkwabyo	h\ i n k w a bj O
hinkwako	h\ i n k w a k O
hinkwao	h\ i n k w a O
hinkwaro	h\ i n k w a r O
hinkwaswo	h\ i n k w a s` O
hinkwato	h\ i n k w a t_> O
hinkwavo	h\ i n k w a B O
hinkwawo	h\ i n k w a w O
hinkwaxo	h\ i n k w a S O
hinkwayo	h\ i n k w a j O
hiolko	h\ i O l k O
hiri	h\ i r i
hisa	h\ i s a
hisaku	h\ i s a k u
hisi	h\ i s i
hisile	h\ i s i l E
hisiwi	h\ i s i w i
hiswona	h\ i s` O n a
hit	h\ i t_>
hita	h\ i t_> a
hitekani	h\ i t_> E k a n i
hiti	h\ i t_> i
hitimanga	h\ i t_> i m a N g a
hitinhompfu	h\ i t_> i n_h O m p f u
hitsema	h\ i tS_> E m a
hiv	h\ i B
hiva	h\ i B a
hiwu	h\ i w u
hixa	h\ i S a
hixi	h\ i S i
hiya	h\ i j a
hiyi	h\ i j i
hiyona	h\ i j O n a
hl	E tS_h a l
hlabangwani	K a b_< a N g w a n i
hlahluva	K a K u B a
hlahluveni	K a K u B E n i
hlakarile	K a k a r i l E
hlalela	K a l E l a
hlalele	K a l E l E
hlaleleka	K a l E l E k a
hlaleriwa	K a l E r i w a
hlamaria	K a m a r i a
hlamarisa	K a m a r i s a
hlamba	K a m b a
hlambanya	K a m b a J a
hlambanyeriweke	K a m b a J E r i w E k E
hlambela	K a m b E l a
hlambha	K a m b a
hlambi	K a m b i
hlambiwa	K a m b i w a
hlamisa	K a m i s a
hlamula	K a m u l a
hlamulela	K a m u l E l a
hlamuriwa	K a m u r i w a
hlamusela	K a m u s E l a
hlamuseriwa	K a m u s E r i w a
hlamuseriwaka	K a m u s E r i w a k a
hlamuseriweke	K a m u s E r i w E k E
hlangahlanganile	K a N g a K a N g a n i l E
hlangana	K a N g a n a
hlanganani	K a N g a n a n i
hlanganeke	K a N g a n E k E
hlangani	K a N g a n i
hlanganisa	K a N g a n i s a
hlanganisiwile	K a N g a n i s i w i l E
hlangano	K a N g a n O
hlanganyetane	K a N g a J E t_> a n E
hlanganyetaniwe	K a N g a J E t_> a n i w E
hlanganyisa	K a N g a J i s a
hlangula	K a N g u l a
hlantswa	K a n tS_> w a
hlantswekeke	K a n tS_> w E k E k E
hlantsweriwa	K a n tS_> w E r i w a
hlantswiwa	K a n tS_> w i w a
hlasela	K a s E l a
hlaselo	K a s E l O
hlavelela	K a B E l E l a
hlaveleriwa	K a B E l E r i w a
hlavutela	K a B u t_> E l a
hlawu	K a w u
hlawula	K a w u l a
hlawulani	K a w u l a n i
hlawuleka	K a w u l E k a
hlawuleke	K a w u l E k E
hlawuli	K a w u l i
hlawurile	K a w u r i l E
hlawuriwa	K a w u r i w a
hlawuriwile	K a w u r i w i l E
hlawuteriwa	K a w u t_> E r i w a
hlaya	K a j a
hlayaa	K a j a a
hlayaku	K a j a k u
hlayatibuku	K a j a t_> i b u k u
hlayeka	K a j E k a
hlayekakahle	K a j E k a k a K E
hlayela	K a j E l a
hlayeleka	K a j E l E k a
hlayeleriwa	K a j E l E r i w a
hlayeni	K a j E n i
hlayeriwa	K a j E r i w a
hlayile	K a j i l E
hlayisa	K a j i s a
hlayisaka	K a j i s a k a
hlayiseka	K a j i s E k a
hlayisekile	K a j i s E k i l E
hlayisile	K a j i s i l E
hlayisiwa	K a j i s i w a
hlayiwa	K a j i w a
hleka	K E k a
hlekelela	K E k E l E l a
hleketa	K E k E t_> a
hlekia	K E k i a
hlekisa	K E k i s a
hlekiwi	K E k i w i
hlela	K E l a
hlengelela	K E N g E l E l a
hlengeleta	K E N g E l E t_> a
hleriw	K E r i w
hleriwa	K E r i w a
hleveteriwa	K E B E t_> E r i w a
hliayisekile	K i a j i s E k i l E
hlokomhaka	K O k O m_h a k a
hlola	K O l a
hlomisa	K O m i s a
hlonga	K O N g a
hlongoriwa	K O N g O r i w a
hlonipa	K O n i p a
hlonipha	K O n i p_h a
hlonipheka	K O n i p_h E k a
hloniphi	K O n i p_h i
hloniphiwa	K O n i p_h i w a
hloniphiwaka	K O n i p_h i w a k a
hlota	K O t_> a
hlotiwa	K O t_> i w a
hlovo	K O B O
hluka	K u k a
hlukile	K u k i l E
hluku	K u k u
hlula	K u l a
hlundzukile	K u n' dz` u k i l E
hlupha	K u p_h a
hluphana	K u p_h a n a
hlupheki	K u p_h E k i
hluphi	K u p_h i
hlutiwa	K u t_> i w a
hluvuka	K u B u k a
hluvukaka	K u B u k a k a
hluvukiso	K u B u k i s O
hluvula	K u B u l a
hlwela	K w E l a
ho	h\ O
hofisi	h\ O f i s i
hola	h\ O l a
holelaka	h\ O l E l a k a
holeriwa	h\ O l E r i w a
holi	h\ O l i
holobye	h\ O l O bj E
holodeyi	h\ O l O d E j i
holova	h\ O l O B a
holovela	h\ O l O B E l a
holovisa	h\ O l O B i s a
holy	h\ O l
holy	h\ O l i
homu	h\ O m u
honci	h\ O n tS_> i
hora	h\ O r a
horile	h\ O r i l E
horisa	h\ O r i s a
horiseka	h\ O r i s E k a
hosi	h\ O s i
house	h\ a s
house	h\ O u s E
how	h\ a
how	h\ O w
howile	h\ O w i l E
hoxa	h\ O S a
hoxeka	h\ O S E k a
hoxekeke	h\ O S E k E k E
hoxekile	h\ O S E k i l E
hoxela	h\ O S E l a
hoxile	h\ O S i l E
hoyozela	h\ O j O z E l a
hu	h\ u
hubyeni	h\ u bj E n i
huhula	h\ u h\ u l a
huhwa	h\ u h\ w a
huhwi	h\ u h\ w i
huhwisa	h\ u h\ w i s a
huku	h\ u k u
hukunene	h\ u k u n E n E
hulela	h\ u l E l a
huleriwa	h\ u l E r i w a
huma	h\ u m a
humaka	h\ u m a k a
humanyana	h\ u m a J a n a
hume	h\ u m E
humele	h\ u m E l E
humelela	h\ u m E l E l a
humelelaka	h\ u m E l E l a k a
humeleleke	h\ u m E l E l E k E
humeleleni	h\ u m E l E l E n i
humelerile	h\ u m E l E r i l E
humelerisa	h\ u m E l E r i s a
humeriwe	h\ u m E r i w E
humesa	h\ u m E s a
humeseke	h\ u m E s E k E
humeseriwa	h\ u m E s E r i w a
humesiwa	h\ u m E s i w a
humesiwaku	h\ u m E s i w a k u
humesiweke	h\ u m E s i w E k E
humi	h\ u m i
humile	h\ u m i l E
humiwa	h\ u m i w a
humiwile	h\ u m i w i l E
hunasa	h\ u n a s a
hundile	h\ u n d i l E
hundza	h\ u n' dz` a
hundze	h\ u n' dz` E
hundzeke	h\ u n' dz` E k E
hundzeki	h\ u n' dz` E k i
hundzeli	h\ u n' dz` E l i
hundzeriwe	h\ u n' dz` E r i w E
hundzeriwile	h\ u n' dz` E r i w i l E
hundziki	h\ u n' dz` i k i
hundzile	h\ u n' dz` i l E
hundzisa	h\ u n' dz` i s a
hundziserile	h\ u n' dz` i s E r i l E
hundziseriwa	h\ u n' dz` i s E r i w a
hundziseriwi	h\ u n' dz` i s E r i w i
hundzuka	h\ u n' dz` u k a
hundzuluka	h\ u n' dz` u l u k a
hundzuluxa	h\ u n' dz` u l u S a
hundzuluxiwa	h\ u n' dz` u l u S i w a
hundzuluxiweke	h\ u n' dz` u l u S i w E k E
hungasa	h\ u N g a s a
hungasiwa	h\ u N g a s i w a
hungata	h\ u N g a t_> a
hungela	h\ u N g E l a
hungu	h\ u N g u
hunguta	h\ u N g u t_> a
hunguteka	h\ u N g u t_> E k a
hunguto	h\ u N g u t_> O
hunya	h\ u J a
hurricane	h\ a r i k E n
hurricane	h\ u r r i tS_> a n E
huvo	h\ u B O
huvonkulu	h\ u B O n k u l u
huwa	h\ u w a
hweti	h\ w E t_> i
i	a
ibambela	i b a m b E l a
ibhuku	i b u k u
ibwaantumbuluko	i b w a a n t_> u m b u l u k O
id	i d
idp	i d p
ie	i
ie	i E
ifilimu	i f i l i m u
igama	i g a m a
ihangu	i h\ a N g u
ihhuma	i h\ h\ u m a
ii	a a
ii	i i
ika	i k a
ikhonomi	i k_h O n O m i
ikhunguvanyekile	i k_h u N g u B a J E k i l E
ikonomi	i k O n O m i
ikoti	i k O t_> i
ikuyiva	i k u j i B a
ilava	i l a B a
ima	i m a
imema	i m E m a
imigwalo	i m i g w a l O
imuntu	i m u n t_> u
imutsali	i m u tS_> a l i
in	i n
ina	i n a
inatinhenha	i n a t_> i n_h E n_h a
incambi	i n tS_> a m b i
india	i n d E
india	i n d i a
indies	i n d i E s
indies	i n d i z
indiya	i n d i j a
indlopfu	i n dK O p f u
ingoma	i N g O m a
inki	i n k i
intellectual	i n t_> E l E k tS_h O l
intellectual	i n t_> E l l E tS_> t_> u a l
interface	i n t_> E f E s
interface	i n t_> E r f a tS_> E
international	i n t_> E n a s E n E l
international	i n t_> E r n a t_> i O n a l
internet	i n t_> E r n E t_>
inthanete	i n t_h a n E t_> E
inthanethe	i n t_h a n E t_h E
intlangu	i n tl_> a N g u
intsava	i n tS_> a B a
intumbuluko	i n t_> u m b u l u k O
inyikiwile	i J i k i w i l E
iphasi	i p_h a s i
ira	a a r E
ira	i r a
iranda	i r a n d a
irhandzwa	i rh\ a n' dz` w a
iririmi	i r i r i m i
irish	a r i s
irish	i r i S
is	i s
is	i z
iseries	i s E r i E s
ishamatsonga	i S a m a tS_> O N g a
ishavisa	i S a B i s a
ishilungu	i S i l u N g u
isibawo	i s i b a w O
isikana	i s i k a n a
isindebele	i s i n d E b E l E
ita	i t_> a
italian	i t_> a l E n
italian	i t_> a l i a n
ithandeka	i t_h a n d E k a
itirisana	i t_> i r i s a n a
itiva	i t_> i B a
itlanga	i tl_> a N g a
itsinya	i tS_> i J a
itswayi	i tS_> w a j i
ivangwamabindzu	i B a N g w a m a b i n' dz` u
ivhitiwa	i v i t_> i w a
ivi	i B i
iwa	i w a
iwadlanga	i w a dK a N g a
iwaikonomi	i w a i k O n O m i
iwaku	i w a k u
iwashimtu	i w a S i m t_> u
iwavafana	i w a B a f a n a
iwile	i w i l E
ixa	i S a
iya	i j a
iyo	i j O
jaha	d_0Z a h\ a
jahha	d_0Z a h\ h\ a
jamela	d_0Z a m E l a
jamelanini	d_0Z a m E l a n i n i
james	d_0Z a m E s
james	d_0Z E m z
january	d_0Z a n j u r i
january	d_0Z a n u a r
jazi	d_0Z a z i
jele	d_0Z E l E
jesi	d_0Z E s i
jet	d_0Z E t_>
jima	d_0Z i m a
jomela	d_0Z O m E l a
jongela	d_0Z O N g E l a
joni	d_0Z O n i
josefa	d_0Z O s E f a
journal	d_0Z a n E l
journal	d_0Z O u r n a l
joyina	d_0Z O j i n a
jse	d_0Z s E
julia	d_0Z u l E
julia	d_0Z u l i a
juliana	d_0Z u l i a n a
julukisa	d_0Z u l u k i s a
july	d_0Z u l
july	d_0Z u l a
junior	d_0Z u n E r
junior	d_0Z u n i O r
ka	k a
kaamerika	k a a m E r i k a
kahholobwe	k a h\ h\ O l O b w E
kahl	k a E tS_h E l
kahle	k a K E
kahlekahle	k a K E k a K E
kakhaleni	k a k_h a l E n i
kaku	k a k u
kala	k a l a
kale	k a l E
kale	k E l
kalelaka	k a l E l a k a
kali	k a l i
kama	k a m a
kamara	k a m a r a
kambe	k a m b E
kambela	k a m b E l a
kambemazulu	k a m b E m a z u l u
kamberiwa	k a m b E r i w a
kamberiweni	k a m b E r i w E n i
kambirhi	k a m b i rh\ i
kambisisiwaka	k a m b i s i s i w a k a
kambisisiweke	k a m b i s i s i w E k E
kambisisiwile	k a m b i s i s i w i l E
kamera	k a m E r a
kamisava	k a m i s a B a
kamnadi	k a m n a d i
kamuke	k a m u k E
kanakana	k a n a k a n a
kanakanisa	k a n a k a n i s a
kandiwa	k a n d i w a
kandliwa	k a n dK i w a
kandza	k a n' dz` a
kandzela	k a n' dz` E l a
kandziyisa	k a n' dz` i j i s a
kandziyisiwa	k a n' dz` i j i s i w a
kaneriwaka	k a n E r i w a k a
kaneriwile	k a n E r i w i l E
kaneta	k a n E t_> a
kanetaka	k a n E t_> a k a
kanetana	k a n E t_> a n a
kanwe	k a n w E
kapaniwa	k a p a n i w a
kaputeni	k a p u t_> E n i
karand	k a r a n d
karata	k a r a t_> a
karati	k a r a t_> i
karhala	k a rh\ a l a
karhali	k a rh\ a l i
karhalisa	k a rh\ a l i s a
karhata	k a rh\ a t_> a
karhateka	k a rh\ a t_> E k a
karhati	k a rh\ a t_> i
karhele	k a rh\ E l E
karhi	k a rh\ i
kariha	k a r i h\ a
karihile	k a r i h\ i l E
kasete	k a s E t_> E
katara	k a t_> a r a
katatana	k a t_> a t_> a n a
katekisa	k a t_> E k i s a
katiko	k a t_> i k O
katrina	k a t_> r i n a
katsa	k a tS_> a
katsaka	k a tS_> a k a
katsakanya	k a tS_> a k a J a
katseki	k a tS_> E k i
katsiwa	k a tS_> i w a
katsiwaka	k a tS_> i w a k a
katsiwile	k a tS_> i w i l E
katsongo	k a tS_> O N g O
kaunda	k a u n d a
kavanyetaka	k a B a J E t_> a k a
kaxiyani	k a S i j a n i
kaya	k a j a
kayivela	k a j i B E l a
kayivelanyana	k a j i B E l a J a n a
ke	k E
kecela	k E tS_> E l a
kelela	k E l E l a
kelemile	k E l E m i l E
kelula	k E l u l a
kendliwa	k E n dK i w a
kera	k E r a
kereke	k E r E k E
keriwa	k E r i w a
ketlela	k E tl_> E l a
ketlele	k E tl_> E l E
khadi	k_h a d i
khalanga	k_h a l a N g a
khale	k_h a l E
khalemabazi	k_h a l E m a b a z i
khaleni	k_h a l E n i
khaleyi	k_h a l E j i
khalibirexini	k_h a l i b i r E S i n i
khaluta	k_h a l u t_> a
khalwe	k_h a l w E
khampani	k_h a m p a n i
khandziya	k_h a n' dz` i j a
khandziyeka	k_h a n' dz` i j E k a
khandziyeki	k_h a n' dz` i j E k i
khandziyile	k_h a n' dz` i j i l E
khandziyiwile	k_h a n' dz` i j i w i l E
khani	k_h a n i
khansele	k_h a n s E l E
khanyisa	k_h a J i s a
khapa	k_h a p a
khapu	k_h a p u
kharikhulamu	k_h a r i k_h u l a m u
khasimende	k_h a s i m E n d E
khata	k_h a t_> a
khataza	k_h a t_> a z a
khatisa	k_h a t_> i s a
khavisa	k_h a B i s a
khavisiwa	k_h a B i s i w a
khazamula	k_h a z a m u l a
khedzakheza	k_h E dz` a k_h E z a
khegwani	k_h E g w a n i
kheni	k_h E n i
khenseka	k_h E n s E k a
kherefu	k_h E r E f u
khidzama	k_h i dz` a m a
khirefu	k_h i r E f u
khirikete	k_h i r i k E t_> E
khironiki	k_h i r O n i k i
khisimusi	k_h i s i m u s i
khitikana	k_h i t_> i k a n a
khiwa	k_h i w a
khlae	k_h K a E
khobeni	k_h O b E n i
khodi	k_h O d i
kholomo	k_h O l O m O
khoma	k_h O m a
khomangi	k_h O m a N g i
khomanisiweke	k_h O m a n i s i w E k E
khombeni	k_h O m b E n i
khombisiwa	k_h O m b i s i w a
khombo	k_h O m b O
khombomuni	k_h O m b O m u n i
khome	k_h O m E
khomekiki	k_h O m E k i k i
khomelele	k_h O m E l E l E
khomeriwa	k_h O m E r i w a
khomeriwe	k_h O m E r i w E
khomile	k_h O m i l E
khomisa	k_h O m i s a
khomiwa	k_h O m i w a
khomixinara	k_h O m i S i n a r a
khomixinari	k_h O m i S i n a r i
khomixini	k_h O m i S i n i
khompiyuta	k_h O m p i j u t_> a
khompyutara	k_h O m pj_> u t_> a r a
khonetile	k_h O n E t_> i l E
khonteyinara	k_h O n t_> E j i n a r a
khopi	k_h O p i
khorwisa	k_h O r w i s a
khorwisi	k_h O r w i s i
khotavuxika	k_h O t_> a B u S i k a
khoto	k_h O t_> O
khotsiwa	k_h O tS_> i w a
khubyeni	k_h u bj E n i
khulu	k_h u l u
khuluka	k_h u l u k a
khulukela	k_h u l u k E l a
khulukelana	k_h u l u k E l a n a
khumba	k_h u m b a
khumbana	k_h u m b a n a
khumbeka	k_h u m b E k a
khumbekaka	k_h u m b E k a k a
khumbekaku	k_h u m b E k a k u
khumbhaka	k_h u m b a k a
khumbi	k_h u m b i
khumbiwa	k_h u m b i w a
khume	k_h u m E
khumembirhi	k_h u m E m b i rh\ i
khumenwe	k_h u m E n w E
khumuzeriwa	k_h u m u z E r i w a
khunguluka	k_h u N g u l u k a
khunguvanyisa	k_h u N g u B a J i s a
khupukile	k_h u p u k i l E
khutaza	k_h u t_> a z a
khutaziwa	k_h u t_> a z i w a
khutla	k_h u tl_> a
khuvo	k_h u B O
khuwani	k_h u w a n i
khwatihata	k_h w a t_> i h\ a t_> a
khwayere	k_h w a j E r E
khwirhi	k_h w i rh\ i
ki	k i
kilimanjaro	k i l i m a J d_0Z a r O
king	k i N
king	k i N g
ko	k O
kobeni	k O b E n i
kohlola	k O K O l a
koka	k O k a
kokeka	k O k E k a
kokelana	k O k E l a n a
kokwalaho	k O k w a l a h\ O
kokwana	k O k w a n a
kokwani	k O k w a n i
koma	k O m a
komba	k O m b a
kombaka	k O m b a k a
kombeka	k O m b E k a
kombela	k O m b E l a
kombeleriwaka	k O m b E l E r i w a k a
komberiwa	k O m b E r i w a
komberiweke	k O m b E r i w E k E
kombetela	k O m b E t_> E l a
kombetiweke	k O m b E t_> i w E k E
kombisa	k O m b i s a
kombisaka	k O m b i s a k a
kombisiwa	k O m b i s i w a
kombisiwangi	k O m b i s i w a N g i
kombisiweke	k O m b i s i w E k E
kombiwa	k O m b i w a
kome	k O m E
komile	k O m i l E
komisa	k O m i s a
komisiwa	k O m i s i w a
komisiweke	k O m i s i w E k E
komiti	k O m i t_> i
kona	k O n a
kongoma	k O N g O m a
kongomangihi	k O N g O m a N g i h\ i
kongomangiki	k O N g O m a N g i k i
kongomanile	k O N g O m a n i l E
kongomeke	k O N g O m E k E
kongomisa	k O N g O m i s a
kongomisiwa	k O N g O m i s i w a
kongomisiweke	k O N g O m i s i w E k E
kongomiweke	k O N g O m i w E k E
kontiraka	k O n t_> i r a k a
kontraka	k O n t_> r a k a
kopiwa	k O p i w a
koporo	k O p O r O
koppen	k O p E n
koppen	k O p p E n
koreketa	k O r E k E t_> a
koroni	k O r O n i
kota	k O t_> a
kotaka	k O t_> a k a
kotaku	k O t_> a k u
kotangi	k O t_> a N g i
kotara	k O t_> a r a
koteka	k O t_> E k a
kotekaka	k O t_> E k a k a
kotekaku	k O t_> E k a k u
koteki	k O t_> E k i
koti	k O t_> i
kotiki	k O t_> i k i
kotisa	k O t_> i s a
koto	k O t_> O
koukota	k O u k O t_> a
kova	k O B a
koxa	k O S a
krebb	k r E b
krebb	k r E b b
ku	k u
kucetela	k u tS_> E t_> E l a
kudya	k u dj a
kudyondzeka	k u dj O n' dz` E k a
kudzunisa	k u dz` u n i s a
kufamba	k u f a m b a
kufeni	k u f E n i
kufumela	k u f u m E l a
kufumeta	k u f u m E t_> a
kuhanya	k u h\ a J a
kuhlamba	k u K a m b a
kuhlanganisa	k u K a N g a n i s a
kuhlaya	k u K a j a
kuhorisa	k u h\ O r i s a
kuhumule	k u h\ u m u l E
kuja	k u d_0Z a
kukoma	k u k O m a
kuku	k u k u
kukula	k u k u l a
kukuma	k u k u m a
kukuriwa	k u k u r i w a
kula	k u l a
kulahi	k u l a h\ i
kulava	k u l a B a
kule	k u l E
kulu	k u l u
kulwa	k u l w a
kuma	k u m a
kumaka	k u m a k a
kumaku	k u m a k u
kumamacheleni	k u m a m a tS_h E l E n i
kumbe	k u m b E
kumbeteleka	k u m b E t_> E l E k a
kumbexani	k u m b E S a n i
kumeka	k u m E k a
kumekaka	k u m E k a k a
kumekaku	k u m E k a k u
kumeke	k u m E k E
kumekile	k u m E k i l E
kumeriwa	k u m E r i w a
kumi	k u m i
kumile	k u m i l E
kumiwa	k u m i w a
kumiwahi	k u m i w a h\ i
kumiwaka	k u m i w a k a
kumiweke	k u m i w E k E
kumpfampfarhutiwa	k u m p f a m p f a rh\ u t_> i w a
kun	k u n
kuna	k u n a
kunene	k u n E n E
kunga	k u N g a
kungari	k u N g a r i
kunguhatiseke	k u N g u h\ a t_> i s E k E
kunguhatiwanga	k u N g u h\ a t_> i w a N g a
kunguhatiwangi	k u N g u h\ a t_> i w a N g i
kunguhatiwile	k u N g u h\ a t_> i w i l E
kuni	k u n i
kunona	k u n O n a
kunyunrwela	k u J u n r w E l a
kupfuriwa	k u p f u r i w a
kupfusha	k u p f u S a
kura	k u r a
kurhangela	k u rh\ a N g E l a
kurhula	k u rh\ u l a
kurhunga	k u rh\ u N g a
kuri	k u r i
kurile	k u r i l E
kurisa	k u r i s a
kushava	k u S a B a
kushishima	k u S i S i m a
kusuhani	k u s u h\ a n i
kusuhi	k u s u h\ i
kusukela	k u s u k E l a
kuta	k u t_> a
kutala	k u t_> a l a
kutani	k u t_> a n i
kutaniu	k u t_> a n i u
kuthiwa	k u t_h i w a
kuti	k u t_> i
kutitimela	k u t_> i t_> i m E l a
kutiya	k u t_> i j a
kutlanga	k u tl_> a N g a
kutlangeliwa	k u tl_> a N g E l i w a
kutsala	k u tS_> a l a
kutsekatseka	k u tS_> E k a tS_> E k a
kutsekatsekaka	k u tS_> E k a tS_> E k a k a
kutsongo	k u tS_> O N g O
kutsutsuma	k u tS_> u tS_> u m a
kutwala	k u t_> w a l a
kuva	k u B a
kuveketela	k u B E k E t_> E l a
kuvona	k u B O n a
kuvulavuriwa	k u B u l a B u r i w a
kuwa	k u w a
kuxava	k u S a B a
kuxaviseni	k u S a B i s E n i
kuxi	k u S i
kuya	k u j a
kuyavunywa	k u j a B u J w a
kuyi	k u j i
kwala	k w a l a
kwalomu	k w a l O m u
kwasa	k w a s a
kwatile	k w a t_> i l E
kwayere	k w a j E r E
kweletaku	k w E l E t_> a k u
kwembe	k w E m b E
kwetlembetana	k w E tl_> E m b E t_> a n a
kwetsima	k w E tS_> i m a
kwhaya	k w h\ a j a
kwihi	k w i h\ i
kwini	k w i n i
kwokwani	k w O k w a n i
la	l a
laafrika	l a a f r i k a
laha	l a h\ a
lahleka	l a K E k a
lahlekeli	l a K E k E l i
lahlekeriwa	l a K E k E r i w a
lahlekeriwahi	l a K E k E r i w a h\ i
lahlekeriwe	l a K E k E r i w E
lahleki	l a K E k i
lahlekile	l a K E k i l E
lahlenxavo	l a K E n S a B O
lahli	l a K i
lahliwi	l a K i w i
lahuliwa	l a h\ u l i w a
lala	l a l a
laleli	l a l E l i
lam	l a m
lam	l E m
lama	l a m a
lama	l E m E
lamakulu	l a m a k u l u
lamantshwa	l a m a n tS_h w a
lamantsongo	l a m a n tS_> O N g O
lamatsongo	l a m a tS_> O N g O
lambu	l a m b u
lamo	l a m O
lana	l a n a
land	l a n d
landela	l a n d E l a
landza	l a n' dz` a
landzaku	l a n' dz` a k u
landzela	l a n' dz` E l a
landzelaka	l a n' dz` E l a k a
landzelela	l a n' dz` E l E l a
landzelelangi	l a n' dz` E l E l a N g i
landzelerile	l a n' dz` E l E r i l E
landzeleriwa	l a n' dz` E l E r i w a
landzeleriwanga	l a n' dz` E l E r i w a N g a
landzeleriwile	l a n' dz` E l E r i w i l E
landzeriwa	l a n' dz` E r i w a
landziwa	l a n' dz` i w a
langa	l a N g a
langha	l a N gh\ a
langhiwa	l a N gh\ i w a
langhiweke	l a N gh\ i w E k E
language	l a N g u a g E
language	l a N g w i d_0Z
languta	l a N g u t_> a
langutana	l a N g u t_> a n a
langutaniwa	l a N g u t_> a n i w a
languteki	l a N g u t_> E k i
langutela	l a N g u t_> E l a
langutele	l a N g u t_> E l E
languteriwa	l a N g u t_> E r i w a
languteriwaka	l a N g u t_> E r i w a k a
languteriweke	l a N g u t_> E r i w E k E
languti	l a N g u t_> i
langutisa	l a N g u t_> i s a
langutisela	l a N g u t_> i s E l a
langutisisa	l a N g u t_> i s i s a
langutisiwa	l a N g u t_> i s i w a
langutiwa	l a N g u t_> i w a
langutiweke	l a N g u t_> i w E k E
lani	l a n i
lapi	l a p i
largest	l a d_0Z E s t_>
largest	l a r g E s t_>
lashishimiwaka	l a S i S i m i w a k a
lastest	l a s t_> E s t_>
latikweni	l a t_> i k w E n i
latin	l a t_> E n
latin	l a t_> i n
laureates	l a u r E a t_> E s
laureates	l O r E t_> s
lava	l a B a
lava	l a v E
lavaka	l a B a k a
lavaku	l a B a k u
lavakulu	l a B a k u l u
lavantshwa	l a B a n tS_h w a
lavantsongo	l a B a n tS_> O N g O
lavatsongo	l a B a tS_> O N g O
laveka	l a B E k a
lavekaka	l a B E k a k a
lavekaloko	l a B E k a l O k O
lavekeki	l a B E k E k i
laveki	l a B E k i
lavekiki	l a B E k i k i
lavela	l a B E l a
lavi	l a B i
lavikiki	l a B i k i k i
lavisisa	l a B i s i s a
laviwa	l a B i w a
laviwaka	l a B i w a k a
lavo	l a B O
law	l a w
law	l O
lawa	l a w a
lawaiya	l a w a i j a
lawakunimichini	l a w a k u n i m i tS_h i n i
lawula	l a w u l a
lawulaka	l a w u l a k a
lawuleriweke	l a w u l E r i w E k E
lawuriwa	l a w u r i w a
laya	l a j a
layiburari	l a j i b u r a r i
layisense	l a j i s E n s E
le	l E
league	l E a g u E
league	l i g
lebulu	l E b u l u
lebyi	l E bj i
lebyikulukumba	l E bj i k u l u k u m b a
lebyiya	l E bj i j a
lee	l E E
lee	l i
leha	l E h\ a
lehe	l E h\ E
lehenhla	l E h\ E n K a
lehile	l E h\ i l E
lehisa	l E h\ i s a
lekosi	l E k O s i
leku	l E k u
lelana	l E l a n a
lembe	l E m b E
lemuka	l E m u k a
lemukanyana	l E m u k a J a n a
lemukisa	l E m u k i s a
leo	l E O
leo	l i O
leri	l E r i
lerinene	l E r i n E n E
leringa	l E r i N g a
lerisiweke	l E r i s i w E k E
leriya	l E r i j a
lero	l E r O
leshi	l E S i
lesindebele	l E s i n d E b E l E
leswaku	l E s` a k u
leswakuswa	l E s` a k u s` a
leswakuva	l E s` a k u B a
leswi	l E s` i
leswimbirhi	l E s` i m b i rh\ i
leswin	l E s` i n
leswiya	l E s` i j a
leswo	l E s` O
letela	l E t_> E l a
leti	l E t_> i
letinga	l E t_> i N g a
letinwana	l E t_> i n w a n a
letiya	l E t_> i j a
levhele	l E v E l E
lexi	l E S i
lexiya	l E S i j a
lexo	l E S O
leyi	l E j i
leyia	l E j i a
leyikulu	l E j i k u l u
leyinsanani	l E j i n s a n a n i
leyo	l E j O
liberal	l E b E r E l
liberal	l i b E r a l
library	l a b r E r i
library	l i b r a r
libya	l E b E
libya	l i bj a
life	l a f
life	l i f E
likhona	l i k_h O n a
linki	l i n k i
liphiwa	l i p_h i w a
livhara	l i v a r a
livhi	l i v i
liya	l i j a
lo	l O
lobukhulu	l O b u k_h u l u
loke	l O k E
loko	l O k O
lokomali	l O k O m a l i
loku	l O k u
lokuthaba	l O k u t_h a b a
lokuvaja	l O k u B a d_0Z a
lolko	l O l k O
lolowa	l O l O w a
lomba	l O m b a
lombisa	l O m b i s a
lomu	l O m u
lonene	l O n E n E
long	l O N
long	l O N g
longolokile	l O N g O l O k i l E
longoloxela	l O N g O l O S E l a
lontsongo	l O n tS_> O N g O
lova	l O B a
loveke	l O B E k E
lovola	l O B O l a
lovolo	l O B O l O
lovoriwa	l O B O r i w a
lowo	l O w O
lowu	l O w u
lowukulu	l O w u k u l u
lowurandziwaka	l O w u r a n' dz` i w a k a
lowutsongo	l O w u tS_> O N g O
loxo	l O S O
loyi	l O j i
lucas	l u k E s
lucas	l u tS_> a s
luka	l u k a
lukiwa	l u k i w a
lulama	l u l a m a
lulamangiki	l u l a m a N g i k i
lulamile	l u l a m i l E
lulamisa	l u l a m i s a
lulamiseke	l u l a m i s E k E
lulamisela	l u l a m i s E l a
luma	l u m a
lume	l u m E
lumeka	l u m E k a
lumekakamara	l u m E k a k a m a r a
lumi	l u m i
lumile	l u m i l E
lundza	l u n' dz` a
lungha	l u N gh\ a
lunghanga	l u N gh\ a N g a
lunghangi	l u N gh\ a N g i
lunghile	l u N gh\ i l E
lunghisiwa	l u N gh\ i s i w a
luuya	l u u j a
luwa	l u w a
luya	l u j a
lwa	l w a
lwandle	l w a n dK E
lwativiwaka	l w a t_> i B i w a k a
lwela	l w E l a
lweriwa	l w E r i w a
lwile	l w i l E
lwisa	l w i s a
lwiwa	l w i w a
ma	m a
maambalela	m a a m b a l E l a
maambalelo	m a a m b a l E l O
maandlalelo	m a a n dK a l E l O
maandlelelo	m a a n dK E l E l O
maangulelo	m a a N g u l E l O
maantswisele	m a a n tS_> w i s E l E
maasesele	m a a s E s E l E
maavelo	m a a B E l O
mabakwa	m a b a k w a
mabasa	m a b_< a s a
mabazi	m a b a z i
mabhindzu	m a b i n' dz` u
mabhuruku	m a b u r u k u
mabibi	m a b i b i
mabidzu	m a b i dz` u
mabiloho	m a b i l O h\ O
mabindzu	m a b i n' dz` u
maboboma	m a b O b_< O m a
mabubutsa	m a b u b u tS_> a
mabulomu	m a b u l O m u
mabumabumeri	m a b u m a b u m E r i
mabunda	m a b u n d a
mabuni	m a b u n i
maburhuku	m a b u rh\ u k u
maburuku	m a b u r u k u
mabusi	m a b u s i
mabutsu	m a b u tS_> u
mabyanyi	m a bj a J i
mabyasi	m a bj a s i
macatu	m a tS_> a t_> u
machakini	m a tS_h a k i n i
machangana	m a tS_h a N g a n a
machangani	m a tS_h a N g a n i
machela	m a tS_h E l a
macheleni	m a tS_h E l E n i
machereni	m a tS_h E r E n i
machipisi	m a tS_h i p i s i
madeha	m a d E h\ a
madhokodele	m a dh\ O k O d E l E
madlala	m a dK a l a
madlayisani	m a dK a j i s a n i
madleke	m a dK E k E
madokodela	m a d O k O d E l a
madonga	m a d O N g a
madonsi	m a d O n s i
madoropo	m a d O r O p O
madumelani	m a d u m E l a n i
maduvhelo	m a d u v E l O
madyambu	m a dj a m b u
madyatshamile	m a dj a tS_h a m i l E
madyaxihi	m a dj a S i h\ i
madyisa	m a dj i s a
madyondza	m a dj O n' dz` a
madzolonga	m a dz` O l O N g a
madzovo	m a dz` O B O
maencisi	m a E n tS_> i s i
maendla	m a E n dK a
maendlele	m a E n dK E l E
maendlelo	m a E n dK E l O
mafadeni	m a f a d E n i
mafamba	m a f a m b a
mafambisele	m a f a m b i s E l E
mafambiselo	m a f a m b i s E l O
mafana	m a f a n a
mafanato	m a f a n a t_> O
mafanele	m a f a n E l E
mafarana	m a f a r a n a
mafarani	m a f a r a n i
mafenya	m a f E J a
mafowani	m a f O w a n i
mafu	m a f u
mafurha	m a f u rh\ a
magadlati	m a g a dK a t_> i
magava	m a g a B a
magaza	m a g a z a
magazini	m a g a z i n i
magezi	m a g E z i
maghaaza	m a gh\ a a z a
magidimbirhi	m a g i d i m b i rh\ i
magoda	m a g O d a
magoji	m a g O d_0Z i
magondzo	m a g O n' dz` O
magoro	m a g O r O
magova	m a g O B a
magoza	m a g O z a
magudufurayideyi	m a g u d u f u r a j i d E j i
maguja	m a g u d_0Z a
magume	m a g u m E
maguva	m a g u B a
magwaza	m a g w a z a
mahala	m a h\ a l a
mahandza	m a h\ a n' dz` a
mahangi	m a h\ a N g i
mahanyele	m a h\ a J E l E
mahanyelo	m a h\ a J E l O
maharadeni	m a h\ a r a d E n i
mahawu	m a h\ a w u
mahebe	m a h\ E b E
mahetelelo	m a h\ E t_> E l E l O
mahhungu	m a h\ h\ u N g u
mahikaha	m a h\ i k a h\ a
mahikahatelo	m a h\ i k a h\ a t_> E l O
mahinga	m a h\ i N g a
mahiselo	m a h\ i s E l O
mahlamulelo	m a K a m u l E l O
mahlamuselelo	m a K a m u s E l E l O
mahlanganiso	m a K a N g a n i s O
mahlawulelo	m a K a w u l E l O
mahlawuri	m a K a w u r i
mahlaya	m a K a j a
mahlayelo	m a K a j E l O
mahlo	m a K O
mahlonga	m a K O N g a
mahluvukisele	m a K u B u k i s E l E
mahlwei	m a K w E i
mahlweni	m a K w E n i
mahobomu	m a h\ O b_< O m u
mahuma	m a h\ u m a
mahungu	m a h\ u N g u
mai	m a i
main	m a i n
main	m E n
majaha	m a d_0Z a h\ a
majambu	m a d_0Z a m b u
majeff	m a d_0Z E f f
majisitarata	m a d_0Z i s i t_> a r a t_> a
major	m a d_0Z O r
major	m E d_0Z E r
maka	m a k a
makamba	m a k a m b a
makampfu	m a k a m p f u
makanelwa	m a k a n E l w a
makanyi	m a k a J i
makapana	m a k a p a n a
makarata	m a k a r a t_> a
makarati	m a k a r a t_> i
makaya	m a k a j a
makehele	m a k E h\ E l E
makete	m a k E t_> E
makhaladi	m a k_h a l a d i
makhanani	m a k_h a n a n i
makhanduli	m a k_h a n d u l i
makhasa	m a k_h a s a
makhele	m a k_h E l E
makhelwani	m a k_h E l w a n i
makhensa	m a k_h E n s a
makhisimisi	m a k_h i s i m i s i
makhisimusi	m a k_h i s i m u s i
makhombo	m a k_h O m b O
makhomele	m a k_h O m E l E
makhomoredi	m a k_h O m O r E d i
makhume	m a k_h u m E
makhutla	m a k_h u tl_> a
makhuwani	m a k_h u w a n i
makhwaya	m a k_h w a j a
makhwiri	m a k_h w i r i
makipikipi	m a k i p i k i p i
makokisi	m a k O k i s i
makomba	m a k O m b a
makombandlela	m a k O m b a n dK E l a
makondlo	m a k O n dK O
makorhweni	m a k O rh\ w E n i
makoti	m a k O t_> i
makotopong	m a k O t_> O p O N g
makula	m a k u l a
makulu	m a k u l u
makumenkaye	m a k u m E n k a j E
makumu	m a k u m u
makungu	m a k u N g u
makwakwatima	m a k w a k w a t_> i m a
makwapa	m a k w a p a
makwembe	m a k w E m b E
makwenu	m a k w E n u
makwerhu	m a k w E rh\ u
makwonga	m a k w O N g a
malahla	m a l a K a
malambhu	m a l a m b u
malamula	m a l a m u l a
malamulele	m a l a m u l E l E
malangadza	m a l a N g a dz` a
malangavi	m a l a N g a B i
malawulele	m a l a w u l E l E
malayisense	m a l a j i s E n s E
malden	m a l d E n
male	m a l E
male	m E l
malebvu	m a l E b v u
malembe	m a l E m b E
malemukelo	m a l E m u k E l O
maleri	m a l E r i
maletere	m a l E t_> E r E
mali	m a l a
mali	m a l i
maliyi	m a l i j i
malongoloxelo	m a l O N g O l O S E l O
malovola	m a l O B O l a
malukelo	m a l u k E l O
malume	m a l u m E
malunghelo	m a l u N gh\ E l O
malwanku	m a l w a n k u
mama	m a m a
mama	m a m E
mamabalelo	m a m a b a l E l O
mamba	m a m b a
mambalelo	m a m b a l E l O
mambe	m a m b E
mambirhi	m a m b i rh\ i
mambisi	m a m b i s i
mambu	m a m b u
mambuxu	m a m b u S u
mamisa	m a m i s a
mamiwa	m a m i w a
mampfampfarhutelo	m a m p f a m p f a rh\ u t_> E l O
mamuntlha	m a m u n tl_h a
man	m a n
mana	m a n a
manana	m a n a n a
mananga	m a n a N g a
manangaswitakala	m a n a N g a s` i t_> a k a l a
manani	m a n a n i
mancomani	m a n tS_> O m a n i
mancomanini	m a n tS_> O m a n i n i
mandela	m a n d E l a
mandela	m a n d E l E
mandelas	m a n d E l a s
mandlakazi	m a n dK a k a z i
mandlhozi	m a n dK\ O z i
mandza	m a n' dz` a
manenge	m a n E N g E
mangadyani	m a N g a dj a n i
manghena	m a N gh\ E n a
manghezi	m a N gh\ E z i
manguva	m a N g u B a
manguvalawa	m a N g u B a l a w a
mangwa	m a N g w a
manharhu	m a n_h a rh\ u
mani	m a n i
maninamani	m a n i n a m a n i
mano	m a n O
manthata	m a n t_h a t_> a
mantshwa	m a n tS_h w a
manu	m a n u
manwani	m a n w a n i
many	m a J
many	m E n i
manya	m a J a
manyika	m a J i k a
manyorha	m a J O rh\ a
manyunyu	m a J u J u
mapa	m a p a
mapapa	m a p a p a
mapapila	m a p a p i l a
mapapu	m a p a p u
mapatu	m a p a t_> u
mapeletelo	m a p E l E t_> E l O
mapeletwana	m a p E l E t_> w a n a
mapeni	m a p E n i
mapfunile	m a p f u n i l E
maphepha	m a p_h E p_h a
maphilisi	m a p_h i l i s i
maphorisa	m a p_h O r i s a
maphorisaya	m a p_h O r i s a j a
mapila	m a p i l a
mapoto	m a p O t_> O
mapu	m a p u
mapuve	m a p u B E
maqhinga	m a !\ h\ i N g a
maraka	m a r a k a
marefu	m a r E f u
marhambu	m a rh\ a m b u
marhandu	m a rh\ a n d u
marhandzu	m a rh\ a n' dz` u
marhanga	m a rh\ a N g a
marhavi	m a rh\ a B i
marhengu	m a rh\ E N g u
marhimila	m a rh\ i m i l a
marhole	m a rh\ O l E
marhumbu	m a rh\ u m b u
maria	m a r i a
maria	m E r E
maribwe	m a r i b w E
maribye	m a r i bj E
marikoti	m a r i k O t_> i
marine	m a r i n E
marine	m E r i n
marito	m a r i t_> O
mariveni	m a r i B E n i
market	m a k E t_>
market	m a r k E t_>
marungulelo	m a r u N g u l E l O
marungulo	m a r u N g u l O
masagwadi	m a s a g w a d i
masagwati	m a s a g w a t_> i
masaka	m a s a k a
masalela	m a s a l E l a
masana	m a s a n a
masangu	m a s a N g u
masasekile	m a s a s E k i l E
masayiti	m a s a j i t_> i
mascots	m a s k E t_> s
mascots	m a s tS_> O tS_>
maseve	m a s E B E
mashamba	m a S a m b a
mashele	m a S E l E
masi	m a s i
masiku	m a s i k u
masikulawa	m a s i k u l a w a
masimu	m a s i m u
masindza	m a s i n' dz` a
masingita	m a s i N g i t_> a
masinwini	m a s i n w i n i
masiokisi	m a s i O k i s i
masipala	m a s i p a l a
masirha	m a s i rh\ a
masivi	m a s i B i
masocha	m a s O tS_h a
masokisi	m a s O k i s i
masokoti	m a s O k O t_> i
masopfa	m a s O p f a
masuke	m a s u k E
masuluvere	m a s u l u B E r E
masungi	m a s u N g i
masungu	m a s u N g u
masungulo	m a s u N g u l O
masuruvele	m a s u r u B E l E
masweka	m a s` E k a
matamatisi	m a t_> a m a t_> i s i
matambha	m a t_> a m b a
matekanelo	m a t_> E k a n E l O
matekelo	m a t_> E k E l O
mateki	m a t_> E k i
mathanga	m a t_h a N g a
mathekisi	m a t_h E k i s i
mathicara	m a t_h i tS_> a r a
mathyakini	m a tj_h a k i n i
mati	m a t_> i
matibyana	m a t_> i bj a n a
matihlo	m a t_> i K O
matik	m a t_> i k
matikhomele	m a t_> i k_h O m E l E
matikhomelo	m a t_> i k_h O m E l O
matiko	m a t_> i k O
matiku	m a t_> i k u
matikwani	m a t_> i k w a n i
matikweni	m a t_> i k w E n i
matilo	m a t_> i l O
matilweni	m a t_> i l w E n i
matimba	m a t_> i m b a
matimu	m a t_> i m u
matini	m a t_> i n i
matino	m a t_> i n O
matinu	m a t_> i n u
matirhelo	m a t_> i rh\ E l O
matirhisele	m a t_> i rh\ i s E l E
matirhiselo	m a t_> i rh\ i s E l O
matirhisisele	m a t_> i rh\ i s i s E l E
mativandlela	m a t_> i B a n dK E l a
matiyisa	m a t_> i j i s a
matiyo	m a t_> i j O
matlangelo	m a tl_> a N g E l O
matlapa	m a tl_> a p a
matlhari	m a tl_h a r i
matlhelo	m a tl_h E l O
matlosane	m a tl_> O s a n E
matlotlo	m a tl_> O tl_> O
matluka	m a tl_> u k a
matolo	m a t_> O l O
matomani	m a t_> O m a n i
matonga	m a t_> O N g a
matsakela	m a tS_> a k E l a
matsalana	m a tS_> a l a n a
matsalelo	m a tS_> a l E l O
matsalwa	m a tS_> a l w a
matsalwalwa	m a tS_> a l w a l w a
matsalwandzungulo	m a tS_> a l w a n' dz` u N g u l O
matsambu	m a tS_> a m b u
matsava	m a tS_> a B a
matsavu	m a tS_> a B u
matsawu	m a tS_> a w u
matshalatshala	m a tS_h a l a tS_h a l a
matshopetana	m a tS_h O p E t_> a n a
matsilele	m a tS_> i l E l E
matsonga	m a tS_> O N g a
matsongo	m a tS_> O N g O
matswa	m a tS_> w a
matutu	m a t_> u t_> u
matwisiselo	m a t_> w i s i s E l O
mau	m a u
maurha	m a u rh\ a
mavabyi	m a B a bj i
mavandla	m a B a n dK a
mavayivayi	m a B a j i B a j i
mavekelo	m a B E k E l O
mavele	m a B E l E
mavengele	m a B E N g E l E
mavhenda	m a v E n d a
mavhengele	m a v E N g E l E
mavhiki	m a v i k i
mavinakule	m a B i n a k u l E
mavis	m a B i s
mavis	m E v E s
maviti	m a B i t_> i
mavito	m a B i t_> O
mavizweni	m a B i z w E n i
mavoko	m a B O k O
mavokweni	m a B O k w E n i
mavona	m a B O n a
mavonakule	m a B O n a k u l E
mavonakuleleyi	m a B O n a k u l E l E j i
mavondzo	m a B O n' dz` O
mavonele	m a B O n E l E
mavonelo	m a B O n E l O
mavula	m a B u l a
mavulwa	m a B u l w a
mavumbelo	m a B u m b E l O
mavunwa	m a B u n w a
mawuwana	m a w u w a n a
mawuwani	m a w u w a n i
maxaka	m a S a k a
maxangu	m a S a N g u
maxaviselo	m a S a B i s E l O
maxaviseloya	m a S a B i s E l O j a
maxaxani	m a S a S a n i
maxele	m a S E l E
maxelo	m a S E l O
maxindyani	m a S i n dj a n i
maxuka	m a S u k a
maya	m a j a
maya	m a j E
mayelana	m a j E l a n a
mayini	m a j i n i
mazambhala	m a z a m b a l a
mazukwa	m a z u k w a
mazulu	m a z u l u
mbabva	m b a b v a
mbaindzu	m b a i n' dz` u
mbala	m b a l a
mbalango	m b a l a N g O
mbale	m b a l E
mbaleka	m b a l E k a
mbalele	m b a l E l E
mbali	m b a l i
mbanga	m b a N g a
mbangi	m b a N g i
mbango	m b a N g O
mbangu	m b a N g u
mbariwa	m b a r i w a
mbariwi	m b a r i w i
mbayna	m b a j n a
mbewu	m b E w u
mbhambha	m b a m b a
mbhiza	m b i z a
mbhojana	m b O d_0Z a n a
mbhurisano	m b u r i s a n O
mbila	m b i l a
mbilu	m b i l u
mbindzimuka	m b i n' dz` i m u k a
mbirhi	m b i rh\ i
mbisane	m b i s a n E
mbisi	m b i s i
mbombomela	m b O m b O m E l a
mbono	m b O n O
mboweni	m b O w E n i
mbulavulo	m b u l a B u l O
mbulavurisano	m b u l a B u r i s a n O
mbuti	m b u t_> i
mbuyelelo	m b u j E l E l O
mbuyelo	m b u j E l O
mbvungunyeni	m b v u N g u J E n i
mbyana	m bj a n a
mchongolo	m tS_h O N g O l O
mdavula	m d a B u l a
mdzi	m d z i
mec	m E tS_>
mejara	m E d_0Z a r a
meleke	m E l E k E
member	m E m b E r
memorandamu	m E m O r a n d a m u
memory	m E m E r i
memory	m E m O r
meno	m E n O
mepe	m E p E
mfana	m f a n a
mfanelo	m f a n E l O
mfava	m f a B a
mfikelelo	m f i k E l E l O
mfugnho	m f u g n_h O
mfumo	m f u m O
mfundhisi	m f u n dh\ i s i
mfungho	m f u N gh\ O
mfuwo	m f u w O
mga	m g a
mhaka	m_h a k a
mhala	m_h a l a
mhalamala	m_h a l a m a l a
mhambanyiselo	m_h a m b a J i s E l O
mhasipala	m_h a s i p a l a
mhawuri	m_h a w u r i
mhelembe	m_h E l E m b E
mhika	m_h i k a
mhlalamhlala	m K a l a m K a l a
mhlava	m K a B a
mi	m i
miako	m i a k O
mianakanyo	m i a n a k a J O
micato	m i tS_> a t_> O
miceka	m i tS_> E k a
michini	m i tS_h i n i
micila	m i tS_> i l a
midyangu	m i dj a N g u
midyondza	m i dj O n' dz` a
mieheketo	m i E h\ E k E t_> O
miehleketo	m i E K E k E t_> O
mieleketo	m i E l E k E t_> O
mifikile	m i f i k i l E
mifumo	m i f u m O
miganga	m i g a N g a
mighingiriko	m i gh\ i N g i r i k O
mighiniriko	m i gh\ i n i r i k O
migilu	m i g i l u
migingiriko	m i g i N g i r i k O
migodi	m i g O d i
mihandzu	m i h\ a n' dz` u
mihkuva	m i h\ k u B a
mihlata	m i K a t_> a
mihlolo	m i K O l O
mihloti	m i K O t_> i
mihlovo	m i K O B O
mihlovohlovo	m i K O B O K O B O
miholo	m i h\ O l O
mikarhi	m i k a rh\ i
mikatsakanyo	m i k a tS_> a k a J O
mikhuva	m i k_h u B a
mikomiso	m i k O m i s O
mikwama	m i k w a m a
mila	m i l a
milambo	m i l a m b O
milambu	m i l a m b u
milanbu	m i l a n b u
milandzu	m i l a n' dz` u
milawu	m i l a w u
milenge	m i l E N g E
military	m i l i t_> a r
military	m i l i t_> r i
milomu	m i l O m u
mimayini	m i m a j i n i
mimbangu	m i m b a N g u
mimbuyelo	m i m b u j E l O
mimepe	m i m E p E
mimfumo	m i m f u m O
mimfungho	m i m f u N gh\ O
mimfuwo	m i m f u w O
mimova	m i m O B a
mimovha	m i m O v a
mimpfumawulo	m i m p f u m a w u l O
mimpfuno	m i m p f u n O
mimpimo	m i m p i m O
mina	m i n a
minceka	m i n tS_> E k a
mincini	m i n tS_> i n i
mincino	m i n tS_> i n O
mindhavuko	m i n dh\ a B u k O
mindyangu	m i n dj a N g u
mindzumba	m i n' dz` u m b a
minete	m i n E t_> E
minga	m i N g a
mingata	m i N g a t_> a
minginisi	m i N g i n i s i
minhlangano	m i n K a N g a n O
minijere	m i n i d_0Z E r E
minimamu	m i n i m a m u
minister	m E n E s t_> E r
minister	m i n i s t_> E r
minkarhi	m i n k a rh\ i
minkhuvo	m i n k_h u B O
minkova	m i n k O B a
minkumba	m i n k u m b a
minongoloko	m i n O N g O l O k O
minongonoko	m i n O N g O n O k O
minsiha	m i n s i h\ a
minsinya	m i n s i J a
mintiho	m i n t_> i h\ O
mintila	m i n t_> i l a
mintirho	m i n t_> i rh\ O
mintlango	m i n tl_> a N g O
mintlangu	m i n tl_> a N g u
mintlangwini	m i n tl_> a N g w i n i
mintlawa	m i n tl_> a w a
mintrho	m i n t_> rh\ O
mintsanda	m i n tS_> a n d a
mintshayito	m i n tS_h a j i t_> O
mintsheketo	m i n tS_h E k E t_> O
mintwanano	m i n t_> w a n a n O
minwala	m i n w a l a
minwana	m i n w a n a
minxaviso	m i n S a B i s O
minxavo	m i n S a B O
minya	m i J a
miphikisano	m i p_h i k i s a n O
mirhi	m i rh\ i
mirhini	m i rh\ i n i
mirhoho	m i rh\ O h\ O
miri	m i r i
mirini	m i r i n i
mirisa	m i r i s a
mirito	m i r i t_> O
miroho	m i r O h\ O
misava	m i s a B a
misaveni	m i s a B E n i
misawu	m i s a w u
misevetho	m i s E B E t_h O
misidi	m i s i d i
misinya	m i s i J a
misisi	m i s i s i
misisileswi	m i s i s i l E s` i
mistrese	m i s t_> r E s E
mita	m i t_> a
miti	m i t_> i
mitiko	m i t_> i k O
mitila	m i t_> i l a
mitirhi	m i t_> i rh\ i
mitirho	m i t_> i rh\ O
mitlango	m i tl_> a N g O
mitlangu	m i tl_> a N g u
mitlanguyatu	m i tl_> a N g u j a t_> u
mitsheketo	m i tS_h E k E t_> O
mitsumbula	m i tS_> u m b u l a
mixaka	m i S a k a
mixava	m i S a B a
mixavo	m i S a B O
mixini	m i S i n i
mixo	m i S O
miyelani	m i j E l a n i
mkhombo	m k_h O m b O
mkombe	m k O m b E
mnhu	m n_h u
mo	m O
moha	m O h\ a
moholo	m O h\ O l O
moloto	m O l O t_> O
mona	m O n a
monday	m a n d E
monday	m O n d a j
mongo	m O N g O
motenga	m O t_> E N g a
mount	m a n t_>
mount	m O u n t_>
movha	m O v a
movies	m O B i E s
movies	m u v i z
moya	m O j a
moyo	m O j O
mpahla	m p a K a
mpandwa	m p a n d w a
mpende	m p E n d E
mpepe	m p E p E
mpfampfarhutiwa	m p f a m p f a rh\ u t_> i w a
mpfampfarhuto	m p f a m p f a rh\ u t_> O
mpfapfarhutiwile	m p f a p f a rh\ u t_> i w i l E
mpfapfarhuto	m p f a p f a rh\ u t_> O
mpfhuka	m p f h\ u k a
mpfula	m p f u l a
mpfumawulo	m p f u m a w u l O
mpfumelelano	m p f u m E l E l a n O
mpfumelelo	m p f u m E l E l O
mpfumelo	m p f u m E l O
mpfumlelelo	m p f u m l E l E l O
mpfumo	m p f u m O
mpfuneto	m p f u n E t_> O
mpfuno	m p f u n O
mpfuxelelo	m p f u S E l E l O
mpfuxeto	m p f u S E t_> O
mphahlo	m p_h a K O
mphahlu	m p_h a K u
mphakelo	m p_h a k E l O
mphamelo	m p_h a m E l O
mphaxani	m p_h a S a n i
mphikizano	m p_h i k i z a n O
mphyandlana	m pj_h a n dK a n a
mpimanyeto	m p i m a J E t_> O
mpimo	m p i m O
mpinamyeto	m p i n a m E t_> O
mpisane	m p i s a n E
mporosi	m p O r O s i
mpundu	m p u n d u
mpundzu	m p u n' dz` u
mswati	m s` a t_> i
mtsalwa	m tS_> a l w a
mtshava	m tS_h a B a
muaka	m u a k a
muakatiko	m u a k a t_> i k O
muako	m u a k O
mubedo	m u b E d O
mubhedo	m u b E d O
mubyali	m u bj a l i
mucato	m u tS_> a t_> O
mucatu	m u tS_> a t_> u
muchato	m u tS_h a t_> O
muchayeri	m u tS_h a j E r i
muchayina	m u tS_h a j i n a
muchini	m u tS_h i n i
muchongolo	m u tS_h O N g O l O
muchuchisi	m u tS_h u tS_h i s i
mudende	m u d E n d E
mudyandzaka	m u dj a n' dz` a k a
mudyaxihi	m u dj a S i h\ i
mudyondzi	m u dj O n' dz` i
mudyondzisi	m u dj O n' dz` i s i
mudyonzi	m u dj O n' z i
mudzaberi	m u dz` a b E r i
mudzabheri	m u dz` a b E r i
muendli	m u E n dK i
mufambi	m u f a m b i
mufambisi	m u f a m b i s i
mufana	m u f a n a
mufi	m u f i
mufundhisi	m u f u n dh\ i s i
muganga	m u g a N g a
mugangeni	m u g a N g E n i
mugayo	m u g a j O
mugayu	m u g a j u
mugevisa	m u g E B i s a
mughivela	m u gh\ i B E l a
mugodi	m u g O d i
mugulugudela	m u g u l u g u d E l a
muhlaveleri	m u K a B E l E r i
muhlavuteri	m u K a B u t_> E r i
muhlayisi	m u K a j i s i
muhlayisiwa	m u K a j i s i w a
muhloti	m u K O t_> i
muhlovo	m u K O B O
muholo	m u h\ O l O
muhoxaxandla	m u h\ O S a S a n dK a
muhoxi	m u h\ O S i
mujaji	m u d_0Z a d_0Z i
mukamberi	m u k a m b E r i
mukamberiwa	m u k a m b E r i w a
mukapa	m u k a p a
mukapu	m u k a p u
mukhacani	m u k_h a tS_> a n i
mukhalabye	m u k_h a l a bj E
mukhandziyi	m u k_h a n' dz` i j i
mukhapu	m u k_h a p u
mukhegwa	m u k_h E g w a
mukhinyavende	m u k_h i J a B E n d E
mukhomi	m u k_h O m i
mukhuhlwana	m u k_h u K w a n a
mukhuhlwani	m u k_h u K w a n i
mukhukhu	m u k_h u k_h u
mukhuva	m u k_h u B a
mukomberi	m u k O m b E r i
mukombisi	m u k O m b i s i
mukonwana	m u k O n w a n a
mukurisi	m u k u r i s i
mulawuri	m u l a w u r i
muleteri	m u l E t_> E r i
mulungu	m u l u N g u
mulwela	m u l w E l a
mulweri	m u l w E r i
mumu	m u m u
mumuntu	m u m u n t_> u
mundlwana	m u n dK w a n a
munduku	m u n d u k u
mundzuku	m u n' dz` u k u
mune	m u n E
munene	m u n E n E
muneri	m u n E r i
munganyo	m u N g a J O
munghana	m u N gh\ a n a
munghenisi	m u N gh\ E n i s i
munghezi	m u N gh\ E z i
mungomeni	m u N g O m E n i
munhu	m u n_h u
muni	m j u n a
muni	m u n i
munti	m u n t_> i
muntima	m u n t_> i m a
munyu	m u J u
muofisiri	m u O f i s i r i
muofisirinkulu	m u O f i s i r i n k u l u
muongori	m u O N g O r i
muphakeri	m u p_h a k E r i
mupu	m u p u
murava	m u r a B a
muravarava	m u r a B a r a B a
murhandzwa	m u rh\ a n' dz` w a
murhangeri	m u rh\ a N g E r i
murhi	m u rh\ i
murhijisitara	m u rh\ i d_0Z i s i t_> a r a
murhumeri	m u rh\ u m E r i
murhungi	m u rh\ u N g i
muri	m u r i
muroho	m u r O h\ O
musa	m u s a
musamariya	m u s a m a r i j a
musava	m u s a B a
musaveni	m u s a B E n i
musayini	m u s a j i n i
musecho	m u s E tS_h O
museketeri	m u s E k E t_> E r i
mushavisi	m u S a B i s i
musi	m u s i
music	m j u z i k
music	m u s i tS_>
musirheleli	m u s i rh\ E l E l i
musirheleri	m u s i rh\ E l E r i
musumbhuluku	m u s u m b u l u k u
musumbhunuku	m u s u m b u n u k u
musumbunuko	m u s u m b u n u k O
muteki	m u t_> E k i
muthelo	m u t_h E l O
muthori	m u t_h O r i
muthotho	m u t_h O t_h O
muti	m u t_> i
mutini	m u t_> i n i
mutirhela	m u t_> i rh\ E l a
mutirhelamfumo	m u t_> i rh\ E l a m f u m O
mutirhi	m u t_> i rh\ i
mutirhisi	m u t_> i rh\ i s i
mutivi	m u t_> i B i
mutjato	m u t_> d_0Z a t_> O
mutlangi	m u tl_> a N g i
mutlhokovetseri	m u tl_h O k O B E tS_> E r i
mutlumuvi	m u tl_> u m u B i
mutsamashitulo	m u tS_> a m a S i t_> u l O
mutsari	m u tS_> a r i
mutsarisi	m u tS_> a r i s i
mutshamaxitulu	m u tS_h a m a S i t_> u l u
mutshami	m u tS_h a m i
mutshayi	m u tS_h a j i
mutsonga	m u tS_> O N g a
mutswari	m u tS_> w a r i
mutumbuluki	m u t_> u m b u l u k i
mutumbuluxi	m u t_> u m b u l u S i
muvumbi	m u B u m b i
muxaka	m u S a k a
muxavi	m u S a B i
muyimbeleri	m u j i m b E l E r i
muyingiseri	m u j i N g i s E r i
muzavalazo	m u z a B a l a z O
n	E n
na	n a
naafrikadzonga	n a a f r i k a dz` O N g a
naiknonomi	n a i k n O n O m i
nakambe	n a k a m b E
nakantsongo	n a k a n tS_> O N g O
nakhosa	n a k_h O s a
nako	n a k O
naku	n a k u
nala	n a l a
namadyambu	n a m a dj a m b u
namajaha	n a m a d_0Z a h\ a
namajambu	n a m a d_0Z a m b u
namasiko	n a m a s i k O
namba	n a m b a
nambu	n a m b u
nambyeni	n a m bj E n i
namntlha	n a m n tl_h a
nampundu	n a m p u n d u
namuntlha	n a m u n tl_h a
namutlha	n a m u tl_h a
nandiha	n a n d i h\ a
nandika	n a n d i k a
nandzelelano	n a n' dz` E l E l a n O
nandziha	n a n' dz` i h\ a
nandzihi	n a n' dz` i h\ i
nandzihisa	n a n' dz` i h\ i s a
nandzika	n a n' dz` i k a
nandziki	n a n' dz` i k i
nandzikisa	n a n' dz` i k i s a
nandzu	n a n' dz` u
nandzulo	n a n' dz` u l O
nanga	n a N g a
nanyama	n a J a m a
nasiku	n a s i k u
naskhathele	n a s k_h a t_h E l E
naspoti	n a s p O t_> i
naswona	n a s` O n a
natamati	n a t_> a m a t_> i
natifilimu	n a t_> i f i l i m u
national	n a s E n E l
national	n a t_> i O n a l
nations	n a t_> i O n s
nations	n E s E n z
navakhale	n a B a k_h a l E
navayimbeleri	n a B a j i m b E l E r i
navela	n a B E l a
navelaka	n a B E l a k a
navera	n a B E r a
navetisiwa	n a B E t_> i s i w a
navetisiwaka	n a B E t_> i s i w a k a
navile	n a B i l E
navina	n a B i n a
navobhasa	n a B O b a s a
navona	n a B O n a
nawamatiko	n a w a m a t_> i k O
nawini	n a w i n i
nawu	n a w u
naxinwana	n a S i n w a n a
nayiti	n a j i t_> i
ncakunya	n tS_> a k u J a
nchumu	n tS_h u m u
ncinca	n tS_> i n tS_> a
ncino	n tS_> i n O
ncisetela	n tS_> i s E t_> E l a
ncop	n k O p
ncop	n tS_> O p
ncuva	n tS_> u B a
ndawu	n d a w u
ndebele	n d E b E l E
ndhaku	n dh\ a k u
ndhambi	n dh\ a m b i
ndhavuko	n dh\ a B u k O
ndhawu	n dh\ a w u
ndhazi	n dh\ a z i
ndhuma	n dh\ u m a
ndhuna	n dh\ u n a
ndhurha	n dh\ u rh\ a
ndlala	n dK a l a
ndlandlamuka	n dK a n dK a m u k a
ndlandlamuko	n dK a n dK a m u k O
ndlandlamuxa	n dK a n dK a m u S a
ndlariwanga	n dK a r i w a N g a
ndlariwangi	n dK a r i w a N g i
ndlati	n dK a t_> i
ndlaya	n dK a j a
ndlayisa	n dK a j i s a
ndlela	n dK E l a
ndlelani	n dK E l a n i
ndli	n d l i
ndliwa	n dK i w a
ndlopfu	n dK O p f u
ndlwini	n dK w i n i
ndwawulo	n d w a w u l O
ndyangu	n dj a N g u
ndyelo	n dj E l O
ndza	n' dz` a
ndzaku	n' dz` a k u
ndzanulo	n' dz` a n u l O
ndzati	n' dz` a t_> i
ndzavisiso	n' dz` a B i s i s O
ndzavuko	n' dz` a B u k O
ndzawulelo	n' dz` a w u l E l O
ndzawulo	n' dz` a w u l O
ndzeni	n' dz` E n i
ndzhaka	n' dz`h\ a k a
ndzhaku	n' dz`h\ a k u
ndzhati	n' dz`h\ a t_> i
ndzhavuko	n' dz`h\ a B u k O
ndzhawu	n' dz`h\ a w u
ndzheko	n' dz`h\ E k O
ndzhendzheleko	n' dz`h\ E n' dz`h\ E l E k O
ndzhuti	n' dz`h\ u t_> i
ndzhutilowu	n' dz`h\ u t_> i l O w u
ndzi	n' dz` i
ndzilava	n' dz` i l a B a
ndzilo	n' dz` i l O
ndzima	n' dz` i m a
ndzimana	n' dz` i m a n a
ndzimanaleyi	n' dz` i m a n a l E j i
ndzimi	n' dz` i m i
ndzindzakhombo	n' dz` i n' dz` a k_h O m b O
ndzinganelo	n' dz` i N g a n E l O
ndzinganiso	n' dz` i N g a n i s O
ndzingano	n' dz` i N g a n O
ndziri	n' dz` i r i
ndzita	n' dz` i t_> a
ndzivalelano	n' dz` i B a l E l a n O
ndziya	n' dz` i j a
ndzulamiso	n' dz` u l a m i s O
ndzumba	n' dz` u m b a
ndzungulo	n' dz` u N g u l O
ndzzhaku	n' dz` z a k u
nekile	n E k i l E
nelson	n E l s O n
nelson	n l s E n
nendze	n E n' dz` E
nene	n E n E
nenge	n E N g E
new	n E w
new	n j u
nga	N g a
ngaka	N g a k a
ngamasiko	N g a m a s i k O
ngana	N g a n a
ngani	N g a n i
ngari	N g a r i
ngati	N g a t_> i
nge	N g E
ngenisa	N g E n i s a
ngesikhuwa	N g E s i k_h u w a
ngesiko	N g E s i k O
ngesindebele	N g E s i n d E b E l E
ngetelela	N g E t_> E l E l a
ngeteleriwa	N g E t_> E l E r i w a
nghala	N gh\ a l a
nghena	N gh\ E n a
nghenani	N gh\ E n a n i
nghene	N gh\ E n E
nghenela	N gh\ E n E l a
nghenelela	N gh\ E n E l E l a
ngheneleriwa	N gh\ E n E l E r i w a
nghenelwe	N gh\ E n E l w E
ngheni	N gh\ E n i
nghenile	N gh\ E n i l E
nghenisa	N gh\ E n i s a
nghenisaka	N gh\ E n i s a k a
nghenisela	N gh\ E n i s E l a
nghenisiwa	N gh\ E n i s i w a
nghenisiwaku	N gh\ E n i s i w a k u
nghingiriko	N gh\ i N g i r i k O
nghoma	N gh\ O m a
nghondo	N gh\ O n d O
nghozi	N gh\ O z i
nghozini	N gh\ O z i n i
nghunghunyana	N gh\ u N gh\ u J a n a
nghunghunyani	N gh\ u N gh\ u J a n i
nghunyuta	N gh\ u J u t_> a
ngi	N g i
ngofu	N g O f u
ngoma	N g O m a
ngomeni	N g O m E n i
ngongeni	N g O N g E n i
ngopfu	N g O p f u
nguluve	N g u l u B E
ngungunyana	N g u N g u J a n a
nguva	N g u B a
nguvo	N g u B O
ngwenya	N g w E J a
nhenha	n_h E n_h a
nhlahluvo	n K a K u B O
nhlamba	n K a m b a
nhlambha	n K a m b a
nhlampfi	n K a m p f i
nhlamulo	n K a m u l O
nhlamuselo	n K a m u s E l O
nhlana	n K a n a
nhlaneki	n K a n E k i
nhlanganelo	n K a N g a n E l O
nhlangano	n K a N g a n O
nhlangula	n K a N g u l a
nhlava	n K a B a
nhlawulo	n K a w u l O
nhlayiseko	n K a j i s E k O
nhlayiso	n K a j i s O
nhlayo	n K a j O
nhlekani	n K E k a n i
nhlengeletano	n K E N g E l E t_> a n O
nhlengelo	n K E N g E l O
nhlengo	n K E N g O
nhlohlotelo	n K O K O t_> E l O
nhloko	n K O k O
nhlokomhaka	n K O k O m_h a k a
nhlokweni	n K O k w E n i
nhlonge	n K O N g E
nhlonhlori	n K O n K O r i
nhlonipho	n K O n i p_h O
nhluvukiso	n K u B u k i s O
nhluvuko	n K u B u k O
nhova	n_h O B a
nhoveni	n_h O B E n i
nhundzu	n_h u n' dz` u
nhungu	n_h u N g u
nhwana	n_h w a n a
nhweti	n_h w E t_> i
ni	n i
night	n a t_>
night	n i gh\ t_>
niku	n i k u
nile	n i l E
nimadyambu	n i m a dj a m b u
nimi	n i m i
ninginika	n i N g i n i k a
ninginikile	n i N g i n i k i l E
nisa	n i s a
nixon	n i k s E n
nixon	n i S O n
niya	n i j a
njhani	J dZh\ a n i
njhini	J dZh\ i n i
njhovo	J dZh\ O B O
nkambelo	n k a m b E l O
nkambisiso	n k a m b i s i s O
nkanelo	n k a n E l O
nkanyi	n k a J i
nkarhi	n k a rh\ i
nkari	n k a r i
nkatanga	n k a t_> a N g a
nkateko	n k a t_> E k O
nkatsakanyo	n k a tS_> a k a J O
nkatsako	n k a tS_> a k O
nkava	n k a B a
nkavanyeto	n k a B a J E t_> O
nkayivelo	n k a j i B E l O
nkele	n k E l E
nkhankha	n k_h a n k_h a
nkhaqato	n k_h a !\ a t_> O
nkhavi	n k_h a B i
nkhensa	n k_h E n s a
nkhinkhi	n k_h i n k_h i
nkhubyeni	n k_h u bj E n i
nkhukhulo	n k_h u k_h u l O
nkhuluk	n k_h u l u k
nkhulukelano	n k_h u l u k E l a n O
nkhuluko	n k_h u l u k O
nkhumbo	n k_h u m b O
nkhuvo	n k_h u B O
nkhuvu	n k_h u B u
nkhuvulo	n k_h u B u l O
nkhwankhwa	n k_h w a n k_h w a
nkhwatihata	n k_h w a t_> i h\ a t_> a
nkoka	n k O k a
nkombe	n k O m b E
nkombo	n k O m b O
nkomiso	n k O m i s O
nkondzo	n k O n' dz` O
nkongomelo	n k O N g O m E l O
nkosi	n k O s i
nkosini	n k O s i n i
nkova	n k O B a
nkowankowa	n k O w a n k O w a
nkuku	n k u k u
nkukulu	n k u k u l u
nkula	n k u l a
nkulo	n k u l O
nkulorhi	n k u l O rh\ i
nkulu	n k u l u
nkulukumba	n k u l u k u m b a
nkuluyi	n k u l u j i
nkumba	n k u m b a
nkuna	n k u n a
nkunguhato	n k u N g u h\ a t_> O
nkungwa	n k u N g w a
nkuwa	n k u w a
nkwalayo	n k w a l a j O
nkwama	n k w a m a
nkwangulatilo	n k w a N g u l a t_> i l O
nkwaswo	n k w a s` O
nkwawomabindzu	n k w a w O m a b i n' dz` u
nkwinika	n k w i n i k a
nmunhu	n m u n_h u
no	n O
nobel	n O b E l
noka	n O k a
nokoto	n O k O t_> O
nokuya	n O k u j a
nombora	n O m b O r a
nomboriweke	n O m b O r i w E k E
nomboro	n O m b O r O
nomination	n O m E n E s E n
nomination	n O m i n a t_> i O n
nominations	n O m E n E s E n z
nominations	n O m i n a t_> i O n s
nomo	n O m O
nomu	n O m u
nona	n O n a
nondzo	n O n' dz` O
nongoloko	n O N g O l O k O
nongonoko	n O N g O n O k O
nonile	n O n i l E
nonisa	n O n i s a
nonoha	n O n O h\ a
norse	n O r s E
norse	n O s
north	n O f
north	n O r t_h
noti	n O t_> i
notlangela	n O tl_> a N g E l a
novhele	n O v E l E
noyi	n O j i
nqambhi	n !\ a m b i
nsati	n s a t_> i
nsawutiso	n s a w u t_> i s O
nsayino	n s a j i n O
nseketelo	n s E k E t_> E l O
nsele	n s E l E
nsena	n s E n a
nseve	n s E B E
nshaviso	n S a B i s O
nshavo	n S a B O
nsiha	n s i h\ a
nsimbhi	n s i m b i
nsimeko	n s i m E k O
nsimu	n s i m u
nsindziso	n s i n' dz` i s O
nsinya	n s i J a
nsirhelelo	n s i rh\ E l E l O
nsovo	n s O B O
nsuku	n s u k u
ntamu	n t_> a m u
ntanga	n t_> a N g a
ntangha	n t_> a N gh\ a
ntanghu	n t_> a N gh\ u
ntangu	n t_> a N g u
ntava	n t_> a B a
ntavasi	n t_> a B a s i
ntikelo	n t_> i k E l O
ntiki	n t_> i k i
ntila	n t_> i l a
ntima	n t_> i m a
ntirho	n t_> i rh\ O
ntiro	n t_> i r O
ntivo	n t_> i B O
ntivomarito	n t_> i B O m a r i t_> O
ntivombangu	n t_> i B O m b a N g u
ntivoririmi	n t_> i B O r i r i m i
ntiyela	n t_> i j E l a
ntiyisiso	n t_> i j i s i s O
ntiyiso	n t_> i j i s O
ntiyisoxidzi	n t_> i j i s O S i dz` i
ntjino	n t_> d_0Z i n O
ntlango	n tl_> a N g O
ntlangu	n tl_> a N g u
ntlangwini	n tl_> a N g w i n i
ntlawa	n tl_> a w a
ntlhantlha	n tl_h a n tl_h a
ntlhanu	n tl_h a n u
ntlhontlho	n tl_h O n tl_h O
ntlimbo	n tl_> i m b O
ntlurhuka	n tl_> u rh\ u k a
ntlurhula	n tl_> u rh\ u l a
ntokoto	n t_> O k O t_> O
ntolovelo	n t_> O l O B E l O
ntombhi	n t_> O m b i
ntombi	n t_> O m b i
ntsaho	n tS_> a h\ O
ntsakelo	n tS_> a k E l O
ntsako	n tS_> a k O
ntsakoeka	n tS_> a k O E k a
ntsala	n tS_> a l a
ntsariso	n tS_> a r i s O
ntsena	n tS_> E n a
ntsene	n tS_> E n E
ntsengele	n tS_> E N g E l E
ntsengo	n tS_> E N g O
ntsetela	n tS_> E t_> E l a
ntsevu	n tS_> E B u
ntshaho	n tS_h a h\ O
ntshava	n tS_h a B a
ntshembo	n tS_h E m b O
ntshikelelo	n tS_h i k E l E l O
ntshilani	n tS_h i l a n i
ntshovelo	n tS_h O B E l O
ntshuke	n tS_h u k E
ntshungu	n tS_h u N g u
ntshunxeko	n tS_h u n S E k O
ntshuri	n tS_h u r i
ntshuxeko	n tS_h u S E k O
ntshuxi	n tS_h u S i
ntsongo	n tS_> O N g O
ntsovelo	n tS_> O B E l O
ntsuka	n tS_> u k a
ntsuvi	n tS_> u B i
ntswalo	n tS_> w a l O
ntswamba	n tS_> w a m b a
ntumbuluko	n t_> u m b u l u k O
ntwanani	n t_> w a n a n i
ntwanano	n t_> w a n a n O
nuha	n u h\ a
nuhwa	n u h\ w a
nuhwana	n u h\ w a n a
nuhwari	n u h\ w a r i
nwa	n w a
nwabindzu	n w a b i n' dz` u
nwamabindzu	n w a m a b i n' dz` u
nwamitwa	n w a m i t_> w a
nwana	n w a n a
nwanaendlwini	n w a n a E n dK w i n i
nwanamapurasi	n w a n a m a p u r a s i
nwananga	n w a n a N g a
nwananwana	n w a n a n w a n a
nwangulano	n w a N g u l a n O
nwansati	n w a n s a t_> i
nwanuna	n w a n u n a
nwasati	n w a s a t_> i
nwatipepe	n w a t_> i p E p E
nwaxemu	n w a S E m u
nwe	n w E
nweka	n w E k a
nwendzahala	n w E n' dz` a h\ a l a
nwendzamhala	n w E n' dz` a m_h a l a
nweti	n w E t_> i
nwi	n w i
nwini	n w i n i
nwinyi	n w i J i
nwiwa	n w i w a
nxaka	n S a k a
nxava	n S a B a
nxavo	n S a B O
nxaxameto	n S a S a m E t_> O
nxiximo	n S i S i m O
nxiyisiso	n S i j i s i s O
nyakanyaka	J a k a J a k a
nyama	J a m a
nyamalala	J a m a l a l a
nyana	J a n a
nyanganya	J a N g a J a
nyangatsa	J a N g a tS_> a
nyanwaka	J a n w a k a
nyanyisa	J a J i s a
nyanyuka	J a J u k a
nyanyuko	J a J u k O
nyanyula	J a J u l a
nyarhi	J a rh\ i
nyawula	J a w u l a
nyawuli	J a w u l i
nyawuri	J a w u r i
nyeleti	J E l E t_> i
nyenyana	J E J a n a
nyenyankulu	J E J a n k u l u
nyenyeni	J E J E n i
nyenyenyana	J E J E J a n a
nyenyenyane	J E J E J a n E
nyenyenyani	J E J E J a n i
nyika	J i k a
nyikaka	J i k a k a
nyikana	J i k a n a
nyikela	J i k E l a
nyikeriwa	J i k E r i w a
nyiketa	J i k E t_> a
nyiketaka	J i k E t_> a k a
nyiketela	J i k E t_> E l a
nyiketiwa	J i k E t_> i w a
nyikiwa	J i k i w a
nyikiwaka	J i k i w a k a
nyikiweke	J i k i w E k E
nyikiwile	J i k i w i l E
nyiko	J i k O
nyilaweke	J i l a w E k E
nyimpi	J i m p i
nyoka	J O k a
nyoneni	J O n E n i
nyongeni	J O N g E n i
nyongwha	J O N g w h\ a
nyuhela	J u h\ E l a
nyuku	J u k u
nyumi	J u m i
nyungubyisa	J u N g u bj i s a
o	O
obama	O b a m a
obama	O b a m E
of	O f
of	O v
office	O f E s
office	O f f i tS_> E
ohikizana	O h\ i k i z a n a
old	O l d
ololoxiwa	O l O l O S i w a
olori	O l O r i
olova	O l O B a
oloveriwa	O l O B E r i w a
olovi	O l O B i
olovisa	O l O B i s a
olovise	O l O B i s E
oma	O m a
omeriwile	O m E r i w i l E
omi	O m i
omo	O m O
omunye	O m u J E
ondza	O n' dz` a
ondzisa	O n' dz` i s a
onge	O N g E
onha	O n_h a
onhaka	O n_h a k a
onhakeriwa	O n_h a k E r i w a
onhaki	O n_h a k i
onhakile	O n_h a k i l E
onhakini	O n_h a k i n i
onhe	O n_h E
onhela	O n_h E l a
onhi	O n_h i
onhile	O n_h i l E
onhiwa	O n_h i w a
orange	O r a N g E
orange	O r i n d_0Z
organization	O g E n a z E s E n
organization	O r g a n i z a t_> i O n
orha	O rh\ a
orhela	O rh\ E l a
orhiwa	O rh\ i w a
orthodox	O f E d O k s
orthodox	O r t_h O d O S
oti	O t_> i
oveleleko	O B E l E l E k O
ovhalodi	O v a l O d i
oyili	O j i l i
oyokuwela	O j O k u w E l a
palestinian	p a l E s t_> i n E n
palestinian	p a l E s t_> i n i a n
palu	p a l u
pandi	p a n d i
pandzisa	p a n' dz` i s a
papawa	p a p a w a
papila	p a p i l a
papilla	p a p i l l a
parreira	p a r r E i r a
party	p a r tj
party	p a t_> i
pasa	p a s a
pasi	p a s i
pasile	p a s i l E
pasisiweke	p a s i s i w E k E
pasiya	p a s i j a
patu	p a t_> u
patwini	p a t_> w i n i
pdf	p d f
pdf	p i d i E f
pela	p E l a
peletela	p E l E t_> E l a
peletwana	p E l E t_> w a n a
penda	p E n d a
pendiwa	p E n d i w a
pendziwile	p E n' dz` i w i l E
pep	p E p
pep	p p
peperha	p E p E rh\ a
perepetwa	p E r E p E t_> w a
perreira	p E r r E i r a
peta	p E t_> a
petiroliyamu	p E t_> i r O l i j a m u
petsapetsa	p E tS_> a p E tS_> a
pfa	p f a
pfala	p f a l a
pfaleriwa	p f a l E r i w a
pfanga	p f a N g a
pfanganisa	p f a N g a n i s a
pfapfarhutiwa	p f a p f a rh\ u t_> i w a
pfariwile	p f a r i w i l E
pfinyiwa	p f i J i w a
pfukani	p f u k a n i
pfuki	p f u k i
pfula	p f u l a
pfuleka	p f u l E k a
pfulela	p f u l E l a
pfumala	p f u m a l a
pfumalaka	p f u m a l a k a
pfumale	p f u m a l E
pfumaleka	p f u m a l E k a
pfumela	p f u m E l a
pfumelela	p f u m E l E l a
pfumelelaka	p f u m E l E l a k a
pfumelelana	p f u m E l E l a n a
pfumeleriwa	p f u m E l E r i w a
pfumeleriwi	p f u m E l E r i w i
pfumeleriwile	p f u m E l E r i w i l E
pfuna	p f u n a
pfunaka	p f u n a k a
pfuneta	p f u n E t_> a
pfuni	p f u n i
pfunile	p f u n i l E
pfuniwa	p f u n i w a
pfurile	p f u r i l E
pfuriwa	p f u r i w a
pfuvapfuvanile	p f u B a p f u B a n i l E
pfuxela	p f u S E l a
pfuxeta	p f u S E t_> a
pfuxetiweke	p f u S E t_> i w E k E
phahla	p_h a K a
phameriwa	p_h a m E r i w a
phamiwa	p_h a m i w a
pharafini	p_h a r a f i n i
pharagirafu	p_h a r a g i r a f u
phasa	p_h a s a
phasipoto	p_h a s i p O t_> O
phasiwa	p_h a s i w a
pheji	p_h E d_0Z i
phela	p_h E l a
phemiti	p_h E m i t_> i
phemu	p_h E m u
phendla	p_h E n dK a
phepha	p_h E p_h a
phephahungu	p_h E p_h a h\ u N g u
phesente	p_h E s E n t_> E
phetroliyamu	p_h E t_> r O l i j a m u
phikizana	p_h i k i z a n a
phina	p_h i n a
phofula	p_h O f u l a
phokotela	p_h O k O t_> E l a
pholisi	p_h O l i s i
phomete	p_h O m E t_> E
phorisa	p_h O r i s a
phuphu	p_h u p_h u
phuraphura	p_h u r a p_h u r a
phurojeke	p_h u r O d_0Z E k E
phyakutela	pj_h a k u t_> E l a
pima	p i m a
pimanisiwa	p i m a n i s i w a
pimanyetiwa	p i m a J E t_> i w a
pimanyisiwaka	p i m a J i s i w a k a
pimiwa	p i m i w a
pimiweke	p i m i w E k E
pirate	p a r E t_>
pirate	p i r a t_> E
pirates	p a r E t_> s
pirates	p i r a t_> E s
pitoli	p i t_> O l i
pitori	p i t_> O r i
place	p l a tS_> E
place	p l E s
plate	p l a t_> E
plate	p l E t_>
players	p l a j E r s
players	p l E E z
polish	p O l i s
polish	p O l i S
pompa	p O m p a
pondho	p O n dh\ O
pondo	p O n d O
pongo	p O N g O
pope	p O p
pope	p O p E
poropita	p O r O p i t_> a
porweni	p O r w E n i
posikarata	p O s i k a r a t_> a
postal	p O s t_> a l
postal	p O s t_> E l
poto	p O t_> O
president	p r E s i d E n t_>
president	p r E z E d E n t_>
presidente	p r E s i d E n t_> E
priest	p r i E s t_>
priest	p r i s t_>
prima	p r i m a
prima	p r i m E
prime	p r a m
prime	p r i m E
printa	p r i n t_> a
product	p r O d a k t_>
product	p r O d u tS_> t_>
programming	p r O g r a m i N
programming	p r O g r a m m i N g
programs	p r O g r a m s
programs	p r O g r a m z
programu	p r O g r a m u
property	p r O p E r tj
property	p r O p E t_> i
protest	p r O t_> E s t_>
provhinsi	p r O v i n s i
provinsi	p r O B i n s i
provixini	p r O B i S i n i
public	p a b l i k
public	p u b l i tS_>
pulana	p u l a n a
pulani	p u l a n i
pulaniwa	p u l a n i w a
puluvulu	p u l u B u l u
pyi	pj_> i
qambha	!\ a m b a
qweta	!\ w E t_> a
r	a r
ra	r a
raambaleka	r a a m b a l E k a
raha	r a h\ a
rahe	r a h\ E
rakamhani	r a k a m_h a n i
rakutswariwa	r a k u tS_> w a r i w a
rakwe	r a k w E
rale	r a l E
rali	r a l i
ralistina	r a l i s t_> i n a
ramanana	r a m a n a n a
ramatsonga	r a m a tS_> O N g a
rambiwe	r a m b i w E
ramina	r a m i n a
ramufana	r a m u f a n a
randi	r a n d i
random	r a n d E m
random	r a n d O m
rantima	r a n t_> i m a
rate	r a t_> E
rate	r E t_>
ratlangeriwa	r a tl_> a N g E r i w a
rava	r a B a
ravuntlhanu	r a B u n tl_h a n u
red	r E d
referense	r E f E r E n s E
regional	r E g i O n a l
regional	r i d_0Z E n E l
registrar	r E d_0Z E s t_> r a r
registrar	r E g i s t_> r a r
rejistara	r E d_0Z i s t_> a r a
rejistariwa	r E d_0Z i s t_> a r i w a
rejistrexini	r E d_0Z i s t_> r E S i n i
relero	r E l E r O
rendzo	r E n' dz` O
repo	r E p O
republic	r E p u b l i tS_>
republic	r i p a b l i k
republican	r E p u b l i tS_> a n
republican	r i p a b l i k E n
rero	r E r O
reru	r E r u
res	r E s
res	r i z
resting	r E s t_> i N
resting	r E s t_> i N g
revenue	r E B E n u E
revenue	r E v E n j u
rhanda	rh\ a n d a
rhandana	rh\ a n d a n a
rhandi	rh\ a n d i
rhandza	rh\ a n' dz` a
rhandzaka	rh\ a n' dz` a k a
rhandzaku	rh\ a n' dz` a k u
rhandzana	rh\ a n' dz` a n a
rhandzi	rh\ a n' dz` i
rhandziwa	rh\ a n' dz` i w a
rhanga	rh\ a N g a
rhangaka	rh\ a N g a k a
rhanganyeto	rh\ a N g a J E t_> O
rhange	rh\ a N g E
rhangela	rh\ a N g E l a
rhangeriwa	rh\ a N g E r i w a
rhangi	rh\ a N g i
rhanza	rh\ a n' z a
rhavi	rh\ a B i
rhejisi	rh\ E d_0Z i s i
rhejisitara	rh\ E d_0Z i s i t_> a r a
rhekhoda	rh\ E k_h O d a
rhekhodi	rh\ E k_h O d i
rhekhodiwa	rh\ E k_h O d i w a
rhendzeleka	rh\ E n' dz` E l E k a
rhendzeleke	rh\ E n' dz` E l E k E
rhetela	rh\ E t_> E l a
rhijisitara	rh\ i d_0Z i s i t_> a r a
rhoko	rh\ O k O
rhomba	rh\ O m b a
rhovoto	rh\ O B O t_> O
rhubiriki	rh\ u b i r i k i
rhula	rh\ u l a
rhulu	rh\ u l u
rhumela	rh\ u m E l a
rhumelela	rh\ u m E l E l a
rhumeriwa	rh\ u m E r i w a
rhumisa	rh\ u m i s a
rhunga	rh\ u N g a
rhungiwa	rh\ u N g i w a
rhurhela	rh\ u rh\ E l a
ri	r i
ribungwani	r i b u N g w a n i
riburantani	r i b u r a n t_> a n i
ribuweni	r i b u w E n i
richard	r i tS_h a r d
richard	r i tS_h E d
richest	r i tS_h E s t_>
richindzile	r i tS_h i n' dz` i l E
ridyambila	r i dj a m b i l a
riendli	r i E n dK i
riendliwa	r i E n dK i w a
riendzo	r i E n' dz` O
rifetho	r i f E t_h O
rifu	r i f u
rifumo	r i f u m O
rifuwo	r i f u w O
rights	r a t_> s
rights	r i gh\ tS_>
riha	r i h\ a
rihanolerinene	r i h\ a n O l E r i n E n E
rihanya	r i h\ a J a
rihanyo	r i h\ a J O
rihanyu	r i h\ a J u
rihati	r i h\ a t_> i
rihatima	r i h\ a t_> i m a
rihhatima	r i h\ h\ a t_> i m a
rihi	r i h\ i
rihlampfu	r i K a m p f u
rihlanganisi	r i K a N g a n i s i
rihlaza	r i K a z a
rihlelo	r i K E l O
rijini	r i d_0Z i n i
rikhondzo	r i k_h O n' dz` O
riki	r i k i
rikulu	r i k u l u
rikumeka	r i k u m E k a
rila	r i l a
rilava	r i l a B a
rile	r a l
rile	r i l E
rilekutlangeni	r i l E k u tl_> a N g E n i
rilisa	r i l i s a
riliwa	r i l i w a
rima	r i m a
rimba	r i m b a
rimbambu	r i m b a m b u
rimbewu	r i m b E w u
rimbilana	r i m b i l a n a
rimbilano	r i m b i l a n O
rimeka	r i m E k a
rimisi	r i m i s i
rimiwa	r i m i w a
rin	r i n
rina	r i n a
rinambala	r i n a m b a l a
rindzeriwile	r i n' dz` E r i w i l E
rinene	r i n E n E
ringana	r i N g a n a
ringanaka	r i N g a n a k a
ringanana	r i N g a n a n a
ringanela	r i N g a n E l a
ringanelangi	r i N g a n E l a N g i
ringe	r i N g E
ringeta	r i N g E t_> a
ringetile	r i N g E t_> i l E
ringetisaka	r i N g E t_> i s a k a
rini	r i n i
rinoko	r i n O k O
rinqingho	r i n !\ i N gh\ O
rinwana	r i n w a n a
rinwani	r i n w a n i
rinwe	r i n w E
ripabliki	r i p a b l i k i
ripela	r i p E l a
ripewu	r i p E w u
ripfalo	r i p f a l O
ripfumelo	r i p f u m E l O
riphabiliki	r i p_h a b i l i k i
riphabliki	r i p_h a b l i k i
riphabuliki	r i p_h a b u l i k i
ripoto	r i p O t_> O
riqingho	r i !\ i N gh\ O
ririmi	r i r i m i
ririrmi	r i r i r m i
ririsa	r i r i s a
risa	r i s a
risavasava	r i s a B a s a B a
rishishima	r i S i S i m a
risimu	r i s i m u
risiwa	r i s i w a
risuna	r i s u n a
rita	r E t_> E
rita	r i t_> a
ritale	r i t_> a l E
ritavi	r i t_> a B i
ritlangi	r i tl_> a N g i
rito	r i t_> O
ritofularha	r i t_> O f u l a rh\ a
rivala	r i B a l a
rivalaka	r i B a l a k a
rivalani	r i B a l a n i
rivaleki	r i B a l E k i
rivalela	r i B a l E l a
rivaleni	r i B a l E n i
rivali	r i B a l i
rivalisa	r i B a l i s a
rivaliwi	r i B a l i w i
rivariwi	r i B a r i w i
rive	r E v
rive	r i B E
rivengo	r i B E N g O
rivilo	r i B i l O
rivolwa	r i B O l w a
rivombo	r i B O m b O
rivoni	r i B O n i
rivubye	r i B u bj E
rixaka	r i S a k a
rixakara	r i S a k a r a
rixile	r i S i l E
rk	a r k E
ro	r O
rocks	r O k s
rocks	r O tS_> k s
rohisa	r O h\ i s a
roman	r O m a n
roman	r O m E n
rona	r O n a
rqingho	r !\ i N gh\ O
rs	a r E s
rugby	r a g b i
rugby	r u g bj
s	E s
sa	s a
saeka	s a E k a
safa	s a f a
sagwadi	s a g w a d i
sagwati	s a g w a t_> i
saints	s a i n tS_>
saints	s E n t_> s
sakamela	s a k a m E l a
sal	s a l
sala	s a l a
saleki	s a l E k i
salela	s a l E l a
saleleke	s a l E l E k E
sambalo	s a m b a l O
sangu	s a N g u
sanhwi	s a n_h w i
sars	s a r s
sasavona	s a s a B O n a
saseka	s a s E k a
sasekile	s a s E k i l E
sasekisa	s a s E k i s a
sasekisiwa	s a s E k i s i w a
sasikiswa	s a s i k i s` a
sathana	s a t_h a n a
sava	s a B a
sayense	s a j E n s E
sayina	s a j i n a
sayiniwa	s a j i n i w a
sayiniweke	s a j i n i w E k E
sayiti	s a j i t_> i
sayizi	s a j i z i
school	s k u l
school	s tS_h O O l
science	s a E n s
science	s tS_> i E n tS_> E
scorer	s k O r E r
scorer	s tS_> O r E r
se	s E
sea	s E a
sea	s i
secha	s E tS_h a
secheni	s E tS_h E n i
sechiwa	s E tS_h i w a
second	s E k E n d
second	s E tS_> O n d
sejeni	s E d_0Z E n i
seketela	s E k E t_> E l a
seketelaka	s E k E t_> E l a k a
seketeriwa	s E k E t_> E r i w a
seketeriweke	s E k E t_> E r i w E k E
sekwa	s E k w a
seleni	s E l E n i
seleteriwile	s E l E t_> E r i w i l E
sente	s E n t_> E
senthara	s E n t_h a r a
sequence	s E !\ u E n tS_> E
sequence	s i k w E n s
sesi	s E s i
setifikheti	s E t_> i f i k_h E t_> i
shah	s a
shah	S a h\
shakespeare	S a k E s p E a r E
shakespeare	s E k s p E r
shana	S a n a
shava	S a B a
shibhelana	S i b E l a n a
shichangani	S i tS_h a N g a n i
shihlawuhlawu	S i K a w u K a w u
shilava	S i l a B a
shiluvana	S i l u B a n a
shintu	S i n t_> u
shipfuna	S i p f u n a
shiteji	S i t_> E d_0Z i
shitsariwile	S i tS_> a r i w i l E
si	E s a
si	s i
sibiya	s i b i j a
sidya	s i dj a
sihlangu	s i K a N g u
sika	s i k a
sikamongameli	s i k a m O N g a m E l i
siku	s i k u
sikunasiku	s i k u n a s i k u
silivhere	s i l i v E r E
simeka	s i m E k a
simekiwa	s i m E k i w a
sindza	s i n' dz` a
sindzisa	s i n' dz` i s a
sindzisiwi	s i n' dz` i s i w i
sinemibala	s i n E m i b a l a
sireleriwa	s i r E l E r i w a
sirhelela	s i rh\ E l E l a
sirheleriwa	s i rh\ E l E r i w a
siringa	s i r i N g a
sisiteme	s i s i t_> E m E
sisitimi	s i s i t_> i m i
sisteme	s i s t_> E m E
siva	s i B a
sivela	s i B E l a
siveriwa	s i B E r i w a
siviwa	s i B i w a
siviwile	s i B i w i l E
siya	s i j a
siyandhani	s i j a n dh\ a n i
siyi	s i j i
siyile	s i j i l E
siyiwe	s i j i w E
slave	s l a B E
slave	s l E v
soccer	s O k E r
soccer	s O tS_> tS_> E r
social	s O s E l
social	s O tS_> i a l
sodomava	s O d O m a B a
sokuvikela	s O k u B i k E l a
somaya	s O m a j a
sombana	s O m b a n a
song	s O N
song	s O N g
sono	s O n O
sonto	s O n t_> O
soto	s O t_> O
soul	s O l
soul	s O u l
south	s a f
south	s O u t_h
southeast	s a f i s t_>
southeast	s O u t_h E a s t_>
sox	s O k s
sox	s O S
spain	s p a i n
spain	s p E n
sport	s p O r t_>
sport	s p O t_>
stars	s t_> a r s
stars	s t_> a z
state	s t_> a t_> E
state	s t_> E t_>
states	s t_> a t_> E s
states	s t_> E t_> s
stock	s t_> O k
stock	s t_> O tS_> k
story	s t_> O r
story	s t_> O r i
street	s t_> r E E t_>
street	s t_> r i t_>
study	s t_> a d i
study	s t_> u dj
sturu	s t_> u r u
success	s E k s E s
success	s u tS_> tS_> E s s
sudi	s u d i
suka	s u k a
sukaka	s u k a k a
sukela	s u k E l a
sukelaka	s u k E l a k a
sula	s u l a
sumela	s u m E l a
sungula	s u N g u l a
sungulaka	s u N g u l a k a
sungulela	s u N g u l E l a
sunguleni	s u N g u l E n i
sungurile	s u N g u r i l E
sunguti	s u N g u t_> i
supply	s E p l a
supply	s u p p l
supreme	s u p r E m E
supreme	s u p r i m
susa	s u s a
susiwa	s u s i w a
susiwe	s u s i w E
suspense	s E s p E n s
suspense	s u s p E n s E
susu	s u s u
sw	E s d a b E l j u
swa	s` a
swachina	s` a tS_h i n a
swahlekisa	s` a K E k i s a
swaka	s` a k a
swakala	s` a k a l a
swakhale	s` a k_h a l E
swaku	s` a k u
swakuda	s` a k u d a
swakudya	s` a k u dj a
swakuja	s` a k u d_0Z a
swakunwa	s` a k u n w a
swalavatsongo	s` a l a B a tS_> O N g O
swale	s` a l E
swama	s` a m a
swamakete	s` a m a k E t_> E
swamasiku	s` a m a s i k u
swambalo	s` a m b a l O
swamintlangu	s` a m i n tl_> a N g u
swamisava	s` a m i s a B a
swandla	s` a n dK a
swatika	s` a t_> i k a
swatimali	s` a t_> i m a l i
swatona	s` a t_> O n a
swava	s` a B a
swavushika	s` a B u S i k a
swayena	s` a j E n a
sweka	s` E k a
swekela	s` E k E l a
swekiwa	s` E k i w a
sweswi	s` E s` i
sweswo	s` E s` O
swi	s` i
swiamalo	s` i a m a l O
swiambalo	s` i a m b a l O
swiana	s` i a n a
swiangi	s` i a N g i
swibalo	s` i b_< a l O
swibamu	s` i b a m u
swibebula	s` i b E b u l a
swibedele	s` i b E d E l E
swibindzwa	s` i b i n' dz` w a
swiboho	s` i b O h\ O
swibukwani	s` i b u k w a n i
swibumabumelo	s` i b u m a b u m E l O
swibyariwa	s` i bj a r i w a
swicele	s` i tS_> E l E
swicelwa	s` i tS_> E l w a
swichaya	s` i tS_h a j a
swichayachayani	s` i tS_h a j a tS_h a j a n i
swichipile	s` i tS_h i p i l E
swichudeni	s` i tS_h u d E n i
swichundeni	s` i tS_h u n d E n i
swidinga	s` i d i N g a
swidya	s` i dj a
swidyondzeki	s` i dj O n' dz` E k i
swidzidziharisi	s` i dz` i dz` i h\ a r i s i
swiendliwa	s` i E n dK i w a
swiendlo	s` i E n dK O
swifaki	s` i f a k i
swifambo	s` i f a m b O
swifaniso	s` i f a n i s O
swifufunhunhu	s` i f u f u n_h u n_h u
swifundza	s` i f u n' dz` a
swifundzankulu	s` i f u n' dz` a n k u l u
swifundzha	s` i f u n' dz`h\ a
swifuva	s` i f u B a
swifuwo	s` i f u w O
swiga	s` i g a
swigandlato	s` i g a n dK a t_> O
swiganga	s` i g a N g a
swigaririmi	s` i g a r i r i m i
swigego	s` i g E g O
swighevenga	s` i gh\ E B E N g a
swighila	s` i gh\ i l a
swighubu	s` i gh\ u b u
swigila	s` i g i l a
swigilamikhuva	s` i g i l a m i k_h u B a
swigubu	s` i g u b u
swigwitsirisi	s` i g w i tS_> i r i s i
swihadyana	s` i h\ a dj a n a
swihangalasamahungu	s` i h\ a N g a l a s a m a h\ u N g u
swiharhi	s` i h\ a rh\ i
swihari	s` i h\ a r i
swihharhi	s` i h\ h\ a rh\ i
swihlahla	s` i K a K a
swihlangi	s` i K a N g i
swihlawulekisi	s` i K a w u l E k i s i
swihlawurekile	s` i K a w u r E k i l E
swihlaya	s` i K a j a
swihlayiselo	s` i K a j i s E l O
swihlovo	s` i K O B O
swihlungwana	s` i K u N g w a n a
swihluvi	s` i K u B i
swihoxo	s` i h\ O S O
swihoxonyana	s` i h\ O S O J a n a
swihungaso	s` i h\ u N g a s O
swikahle	s` i k a K E
swikala	s` i k a l a
swikalichana	s` i k a l i tS_h a n a
swikambelo	s` i k a m b E l O
swikambelwana	s` i k a m b E l w a n a
swikangalafula	s` i k a N g a l a f u l a
swikari	s` i k a r i
swikece	s` i k E tS_> E
swikeche	s` i k E tS_h E
swikete	s` i k E t_> E
swikhome	s` i k_h O m E
swikhukhula	s` i k_h u k_h u l a
swikhumukani	s` i k_h u m u k a n i
swikhwama	s` i k_h w a m a
swikipa	s` i k i p a
swikoka	s` i k O k a
swikokovi	s` i k O k O B i
swikolo	s` i k O l O
swikolweni	s` i k O l w E n i
swikombekiso	s` i k O m b E k i s O
swikombelo	s` i k O m b E l O
swikombiso	s` i k O m b i s O
swikongomelo	s` i k O N g O m E l O
swikota	s` i k O t_> a
swikotela	s` i k O t_> E l a
swikoti	s` i k O t_> i
swikotikoti	s` i k O t_> i k O t_> i
swikoxo	s` i k O S O
swiku	s` i k u
swikukwana	s` i k u k w a n a
swikulu	s` i k u l u
swikumeka	s` i k u m E k a
swikumiwa	s` i k u m i w a
swikweleti	s` i k w E l E t_> i
swikweletu	s` i k w E l E t_> u
swikwembu	s` i k w E m b u
swilahlo	s` i l a K O
swilambe	s` i l a m b E
swilava	s` i l a B a
swilaveko	s` i l a B E k O
swilemu	s` i l E m u
swileriso	s` i l E r i s O
swiletelo	s` i l E t_> E l O
swilo	s` i l O
swilondza	s` i l O n' dz` a
swilulamile	s` i l u l a m i l E
swiluva	s` i l u B a
swimakiwa	s` i m a k i w a
swimawusa	s` i m a w u s a
swimbalo	s` i m b a l O
swimbirhi	s` i m b i rh\ i
swimila	s` i m i l a
swimilana	s` i m i l a n a
swimilani	s` i m i l a n i
swimilwana	s` i m i l w a n a
swimovhana	s` i m O v a n a
swin	s` i n
swina	s` i n a
swinankoka	s` i n a n k O k a
swinavetiso	s` i n a B E t_> i s O
swinawana	s` i n a w a n a
swinchinana	s` i n tS_h i n a n a
swinee	s` i n E E
swinene	s` i n E n E
swinepe	s` i n E p E
swinga	s` i N g a
swingawula	s` i N g a w u l a
swinghenisa	s` i N gh\ E n i s a
swinghomana	s` i N gh\ O m a n a
swingomana	s` i N g O m a n a
swingomani	s` i N g O m a n i
swingomantanda	s` i N g O m a n t_> a n d a
swingwavila	s` i N g w a B i l a
swinharhu	s` i n_h a rh\ u
swini	s` i n i
swinon	s` i n O n
swinonisi	s` i n O n i s i
swinsanani	s` i n s a n a n i
swintshuxo	s` i n tS_h u S O
swintsongo	s` i n tS_> O N g O
swintwa	s` i n t_> w a
swinwana	s` i n w a n a
swinyawula	s` i J a w u l a
swinyenyani	s` i J E J a n i
swipandza	s` i p a n' dz` a
swipanndza	s` i p a n n' dz` a
swipano	s` i p a n O
swipanu	s` i p a n u
swipanza	s` i p a n' z a
swipaqo	s` i p a !\ O
swipato	s` i p a t_> O
swipfuna	s` i p f u n a
swipfuno	s` i p f u n O
swiphato	s` i p_h a t_> O
swiphaza	s` i p_h a z a
swipheme	s` i p_h E m E
swiphemu	s` i p_h E m u
swiphiqo	s` i p_h i !\ O
swipikara	s` i p i k a r a
swipimelo	s` i p i m E l O
swirhalanganyi	s` i rh\ a l a N g a J i
swirhende	s` i rh\ E n d E
swirhenze	s` i rh\ E n' z E
swirho	s` i rh\ O
swirhokwana	s` i rh\ O k w a n a
swirhoma	s` i rh\ O m a
swirhumbani	s` i rh\ u m b a n i
swiri	s` i r i
swirinwiwa	s` i r i n w i w a
swisaka	s` i s a k a
swisani	s` i s a n i
swisasi	s` i s a s i
swiseveseve	s` i s E B E s E B E
swishaviwa	s` i S a B i w a
swisiwana	s` i s i w a n a
switandati	s` i t_> a n d a t_> i
switarateni	s` i t_> a r a t_> E n i
switatimende	s` i t_> a t_> i m E n d E
switayela	s` i t_> a j E l a
switayele	s` i t_> a j E l E
switele	s` i t_> E l E
switelenhlambha	s` i t_> E l E n K a m b a
switereko	s` i t_> E r E k O
switichi	s` i t_> i tS_h i
switifikheti	s` i t_> i f i k_h E t_> i
switiko	s` i t_> i k O
switimela	s` i t_> i m E l a
switina	s` i t_> i n a
switirha	s` i t_> i rh\ a
switirhisiwa	s` i t_> i rh\ i s i w a
switirhiso	s` i t_> i rh\ i s O
switirhiswa	s` i t_> i rh\ i s` a
switirho	s` i t_> i rh\ O
switisa	s` i t_> i s a
switlangi	s` i tl_> a N g i
switlangwana	s` i tl_> a N g w a n a
switlhavelo	s` i tl_h a B E l O
switlhokovetselo	s` i tl_h O k O B E tS_> E l O
switlhuva	s` i tl_h u B a
switlokovetselo	s` i tl_> O k O B E tS_> E l O
switofi	s` i t_> O f i
switoko	s` i t_> O k O
switokofela	s` i t_> O k O f E l a
switolani	s` i t_> O l a n i
switolatolani	s` i t_> O l a t_> O l a n i
switolo	s` i t_> O l O
switorana	s` i t_> O r a n a
switorani	s` i t_> O r a n i
switorhi	s` i t_> O rh\ i
switori	s` i t_> O r i
switoriwa	s` i t_> O r i w a
switoriya	s` i t_> O r i j a
switotrna	s` i t_> O t_> r n a
switsakela	s` i tS_> a k E l a
switsalwambiko	s` i tS_> a l w a m b i k O
switsalwana	s` i tS_> a l w a n a
switshamo	s` i tS_h a m O
switshongo	s` i tS_h O N g O
switshuriwa	s` i tS_h u r i w a
switsongo	s` i tS_> O N g O
switsongwatsongwana	s` i tS_> O N g w a tS_> O N g w a n a
switsongwatsongwani	s` i tS_> O N g w a tS_> O N g w a n i
switsotswana	s` i tS_> O tS_> w a n a
switsotswani	s` i tS_> O tS_> w a n i
switsundzuko	s` i tS_> u n' dz` u k O
switulu	s` i t_> u l u
switumbani	s` i t_> u m b a n i
switumbuluxi	s` i t_> u m b u l u S i
switwananisi	s` i t_> w a n a n i s i
swivandla	s` i B a n dK a
swivandzana	s` i B a n' dz` a n a
swivandzani	s` i B a n' dz` a n i
swivangelo	s` i B a N g E l O
swivangiwa	s` i B a N g i w a
swiviko	s` i B i k O
swivilelo	s` i B i l E l O
swivona	s` i B O n a
swivongo	s` i B O N g O
swivulavulelo	s` i B u l a B u l E l O
swivulavulero	s` i B u l a B u l E r O
swivulwa	s` i B u l w a
swivumbeko	s` i B u m b E k O
swivutiso	s` i B u t_> i s O
swixavisi	s` i S a B i s i
swixavisiwa	s` i S a B i s i w a
swiyani	s` i j a n i
swiyanimoya	s` i j a n i m O j a
swiye	s` i j E
swiyenge	s` i j E N g E
swiyila	s` i j i l a
swiyimbelela	s` i j i m b E l E l a
swiyimbeleri	s` i j i m b E l E r i
swiyimo	s` i j i m O
swiyimu	s` i j i m u
swkudya	s` k u dj a
swo	s` O
swohhambana	s` O h\ h\ a m b a n a
swohlayanyana	s` O K a j a J a n a
swoka	s` O k a
swona	s` O n a
swotala	s` O t_> a l a
swova	s` O B a
swoxe	s` O S E
t	t_> i
ta	t_> a
taafrika	t_> a a f r i k a
tafula	t_> a f u l a
tahluma	t_> a K u m a
taka	t_> a k a
takhale	t_> a k_h a l E
taku	t_> a k u
takuka	t_> a k u k a
takumeka	t_> a k u m E k a
tala	t_> a l a
talanga	t_> a l a N g a
talangi	t_> a l a N g i
talanyana	t_> a l a J a n a
talavheka	t_> a l a v E k a
tale	t_> a l E
tale	t_> E l
talelangi	t_> a l E l a N g i
talele	t_> a l E l E
talelehi	t_> a l E l E h\ i
talenta	t_> a l E n t_> a
tali	t_> a l i
tama	t_> a m a
tamabhindzu	t_> a m a b i n' dz` u
tamabindzu	t_> a m a b i n' dz` u
tamajahha	t_> a m a d_0Z a h\ h\ a
tamatimu	t_> a m a t_> i m u
tambilu	t_> a m b i l u
tamfumo	t_> a m f u m O
tamunhu	t_> a m u n_h u
tana	t_> a n a
tanani	t_> a n a n i
tanda	t_> a n d a
tangile	t_> a N g i l E
tani	t_> a n i
tanihi	t_> a n i h\ i
tanihilaha	t_> a n i h\ i l a h\ a
tano	t_> a n O
tapfuna	t_> a p f u n a
tata	t_> a t_> a
tatana	t_> a t_> a n a
tatara	t_> a t_> a r a
tate	t_> a t_> E
tatile	t_> a t_> i l E
tatimale	t_> a t_> i m a l E
tatiwa	t_> a t_> i w a
tatiwaku	t_> a t_> i w a k u
tatiweke	t_> a t_> i w E k E
tatlavula	t_> a tl_> a B u l a
tava	t_> a B a
tavona	t_> a B O n a
taxi	t_> a k s i
taxi	t_> a S i
tayele	t_> a j E l E
te	t_> E
te	t_> i i
team	t_> E a m
team	t_> i m
teka	t_> E k a
tekana	t_> E k a n a
tekela	t_> E k E l a
tekeriwa	t_> E k E r i w a
tekeriwe	t_> E k E r i w E
tekeriwi	t_> E k E r i w i
teketela	t_> E k E t_> E l a
tekile	t_> E k i l E
tekiwa	t_> E k i w a
tekiwi	t_> E k i w i
tekiwile	t_> E k i w i l E
tekweni	t_> E k w E n i
tele	t_> E l E
tele	t_> E l i
teleni	t_> E l E n i
television	t_> E l E B i s i O n
television	t_> E l i v i d_0Z E n
telo	t_> E l O
tenga	t_> E N g a
tengangi	t_> E N g a N g i
tengangiki	t_> E N g a N g i k i
tengile	t_> E N g i l E
tengisiwa	t_> E N g i s i w a
tengsiwa	t_> E N g s i w a
tennis	t_> E n E s
tennis	t_> E n n i s
terekile	t_> E r E k i l E
thala	t_h a l a
thawula	t_h a w u l a
thawuza	t_h a w u z a
thawuze	t_h a w u z E
thawuziwa	t_h a w u z i w a
thayi	t_h a j i
the	d E
the	t_h E
thekwini	t_h E k w i n i
thelevixini	t_h E l E B i S i n i
themba	t_h E m b a
thenisi	t_h E n i s i
theory	f E r i
theory	t_h E O r
thinini	t_h i n i n i
thlula	t_h K u l a
tholangi	t_h O l a N g i
thoni	t_h O n i
thorile	t_h O r i l E
thoriwa	t_h O r i w a
thoriweke	t_h O r i w E k E
thuga	t_h u g a
thumba	t_h u m b a
thwasa	t_h w a s a
thwaseke	t_h w a s E k E
thya	tj_h a
thyaka	tj_h a k a
thyakisa	tj_h a k i s a
thyeni	tj_h E n i
ti	t_> i
tianswisa	t_> i a n s` i s a
tiantswisa	t_> i a n tS_> w i s a
tiawara	t_> i a w a r a
tiayini	t_> i a j i n i
tiba	t_> i b a
tibangi	t_> i b a N g i
tibasile	t_> i b a s i l E
tibayisikopo	t_> i b a j i s i k O p O
tibeke	t_> i b E k E
tibhuku	t_> i b u k u
tibotsotso	t_> i b O tS_> O tS_> O
tibuku	t_> i b u k u
tibukwini	t_> i b u k w i n i
tibyela	t_> i bj E l a
ticaroti	t_> i tS_> a r O t_> i
tichayihi	t_> i tS_h a j i h\ i
tichungulu	t_> i tS_h u N g u l u
ticondzo	t_> i tS_> O n' dz` O
tidivhayisi	t_> i d i v a j i s i
tidlaya	t_> i dK a j a
tidokhumente	t_> i d O k_h u m E n t_> E
tidokumende	t_> i d O k u m E n d E
tidonki	t_> i d O n k i
tidurile	t_> i d u r i l E
tidyondzo	t_> i dj O n' dz` O
tiendliwa	t_> i E n dK i w a
tifanele	t_> i f a n E l E
tifaneleke	t_> i f a n E l E k E
tifeme	t_> i f E m E
tifilimi	t_> i f i l i m i
tifilimu	t_> i f i l i m u
tifomo	t_> i f O m O
tifomu	t_> i f O m u
tiforamu	t_> i f O r a m u
tigingho	t_> i g i N gh\ O
tigiredi	t_> i g i r E d i
tihakelo	t_> i h\ a k E l O
tihambanyisa	t_> i h\ a m b a J i s a
tihanci	t_> i h\ a n tS_> i
tihanyisa	t_> i h\ a J i s a
tiherelire	t_> i h\ E r E l i r E
tihhomu	t_> i h\ h\ O m u
tihlampfi	t_> i K a m p f i
tihlanganisa	t_> i K a N g a n i s a
tihlanganise	t_> i K a N g a n i s E
tihlanganisiwaka	t_> i K a N g a n i s i w a k a
tihlayise	t_> i K a j i s E
tihlo	t_> i K O
tihlonipa	t_> i K O n i p a
tiholiseli	t_> i h\ O l i s E l i
tihomu	t_> i h\ O m u
tihosi	t_> i h\ O s i
tihove	t_> i h\ O B E
tihuku	t_> i h\ u k u
tihumele	t_> i h\ u m E l E
tihunyi	t_> i h\ u J i
tihuvo	t_> i h\ u B O
tiindastri	t_> i i n d a s t_> r i
tiinjhovo	t_> i i J dZh\ O B O
tiitimela	t_> i i t_> i m E l a
tika	t_> i k a
tikamba	t_> i k a m b a
tikatara	t_> i k a t_> a r a
tikatsa	t_> i k a tS_> a
tikela	t_> i k E l a
tikereke	t_> i k E r E k E
tikerekeni	t_> i k E r E k E n i
tikeriwa	t_> i k E r i w a
tikhampani	t_> i k_h a m p a n i
tikhanselara	t_> i k_h a n s E l a r a
tikhasete	t_> i k_h a s E t_> E
tikhasimende	t_> i k_h a s i m E n d E
tikhategori	t_> i k_h a t_> E g O r i
tikhodi	t_> i k_h O d i
tikholoro	t_> i k_h O l O r O
tikhomba	t_> i k_h O m b a
tikhopi	t_> i k_h O p i
tikhoto	t_> i k_h O t_> O
tikhwayere	t_> i k_h w a j E r E
tikhwini	t_> i k_h w i n i
tikisa	t_> i k i s a
tikisela	t_> i k i s E l a
tikisiwa	t_> i k i s i w a
tikisiweke	t_> i k i s i w E k E
tiko	t_> i k O
tikoleri	t_> i k O l E r i
tikomba	t_> i k O m b a
tikombi	t_> i k O m b i
tikombisa	t_> i k O m b i s a
tikomiti	t_> i k O m i t_> i
tikona	t_> i k O n a
tikontiraka	t_> i k O n t_> i r a k a
tiku	t_> i k u
tikulu	t_> i k u l u
tikuma	t_> i k u m a
tikumaka	t_> i k u m a k a
tikumeka	t_> i k u m E k a
tikumeki	t_> i k u m E k i
tikweni	t_> i k w E n i
tilayeni	t_> i l a j E n i
tilayiburari	t_> i l a j i b u r a r i
tilayisense	t_> i l a j i s E n s E
tilayita	t_> i l a j i t_> a
tile	t_> a l
tile	t_> i l E
tilo	t_> i l O
tilulamiseni	t_> i l u l a m i s E n i
tima	t_> i m a
timakete	t_> i m a k E t_> E
timal	t_> i m a l
timale	t_> i m a l E
timaletatiko	t_> i m a l E t_> a t_> i k O
timali	t_> i m a l i
timanga	t_> i m a N g a
timaraka	t_> i m a r a k a
timayini	t_> i m a j i n i
timayisele	t_> i m a j i s E l E
timbala	t_> i m b a l a
timbambu	t_> i m b a m b u
timbhongolo	t_> i m b O N g O l O
timbhoni	t_> i m b O n i
timbila	t_> i m b i l a
timbilu	t_> i m b i l u
timbirhi	t_> i m b i rh\ i
timbita	t_> i m b i t_> a
timbuti	t_> i m b u t_> i
timbyana	t_> i m bj a n a
timendlele	t_> i m E n dK E l E
times	t_> a m z
times	t_> i m E s
timfanelo	t_> i m f a n E l O
timhaka	t_> i m_h a k a
timhakankulu	t_> i m_h a k a n k u l u
timhakanyana	t_> i m_h a k a J a n a
timhandzi	t_> i m_h a n' dz` i
timholovo	t_> i m_h O l O B O
timhondzo	t_> i m_h O n' dz` O
timinerali	t_> i m i n E r a l i
timinete	t_> i m i n E t_> E
timintsu	t_> i m i n tS_> u
timitara	t_> i m i t_> a r a
timitsu	t_> i m i tS_> u
timofimi	t_> i m O f i m i
timongo	t_> i m O N g O
timovha	t_> i m O v a
timpepe	t_> i m p E p E
timpfula	t_> i m p f u l a
timpfuvu	t_> i m p f u B u
timphaxani	t_> i m p_h a S a n i
tin	t_> E n
tin	t_> i n
tina	t_> E n E
tina	t_> i n a
tinaku	t_> i n a k u
tinanga	t_> i n a N g a
tincambi	t_> i n tS_> a m b i
tindhawini	t_> i n dh\ a w i n i
tindhawu	t_> i n dh\ a w u
tindhuna	t_> i n dh\ u n a
tindimi	t_> i n d i m i
tindlela	t_> i n dK E l a
tindleve	t_> i n dK E B E
tindlo	t_> i n dK O
tindlopfu	t_> i n dK O p f u
tindlu	t_> i n dK u
tindluwa	t_> i n dK u w a
tindlwini	t_> i n dK w i n i
tindzawu	t_> i n' dz` a w u
tindzawulo	t_> i n' dz` a w u l O
tindzimana	t_> i n' dz` i m a n a
tindzimi	t_> i n' dz` i m i
tindzimu	t_> i n' dz` i m u
tindzini	t_> i n' dz` i n i
tinene	t_> i n E n E
tinga	t_> i N g a
tingana	t_> i N g a n a
tingani	t_> i N g a n i
tingedzo	t_> i N g E dz` O
tingena	t_> i N g E n a
tinghedzo	t_> i N gh\ E dz` O
tinghenile	t_> i N gh\ E n i l E
tinghenisa	t_> i N gh\ E n i s a
tinghoma	t_> i N gh\ O m a
tinghuvu	t_> i N gh\ u B u
tinghwazi	t_> i N gh\ w a z i
tingoma	t_> i N g O m a
tingomo	t_> i N g O m O
tingoti	t_> i N g O t_> i
tinguva	t_> i N g u B a
tinguvu	t_> i N g u B u
tinharhu	t_> i n_h a rh\ u
tinhenha	t_> i n_h E n_h a
tinhla	t_> i n K a
tinhlampfi	t_> i n K a m p f i
tinhlamulo	t_> i n K a m u l O
tinhlamuselo	t_> i n K a m u s E l O
tinhlanga	t_> i n K a N g a
tinhlayo	t_> i n K a j O
tinhlengeletano	t_> i n K E N g E l E t_> a n O
tinhloko	t_> i n K O k O
tinhompfu	t_> i n_h O m p f u
tinhweti	t_> i n_h w E t_> i
tini	t_> i n i
tinjhovo	t_> i J dZh\ O B O
tinomboro	t_> i n O m b O r O
tinoro	t_> i n O r O
tinothisi	t_> i n O t_h i s i
tinotlo	t_> i n O tl_> O
tinotsi	t_> i n O tS_> i
tinoveli	t_> i n O B E l i
tinqambhi	t_> i n !\ a m b i
tinqhambi	t_> i n !\ h\ a m b i
tinqingho	t_> i n !\ i N gh\ O
tinsimbhi	t_> i n s i m b i
tinsimu	t_> i n s i m u
tinsimutashintu	t_> i n s i m u t_> a S i n t_> u
tinsu	t_> i n s u
tintambhu	t_> i n t_> a m b u
tintambu	t_> i n t_> a m b u
tintanghu	t_> i n t_> a N gh\ u
tintangu	t_> i n t_> a N g u
tintiho	t_> i n t_> i h\ O
tintlhari	t_> i n tl_h a r i
tintnghu	t_> i n t_> N gh\ u
tintoma	t_> i n t_> O m a
tintombhi	t_> i n t_> O m b i
tintombi	t_> i n t_> O m b i
tintsava	t_> i n tS_> a B a
tintsengele	t_> i n tS_> E N g E l E
tintshava	t_> i n tS_h a B a
tintshimi	t_> i n tS_h i m i
tintshwa	t_> i n tS_h w a
tintsumi	t_> i n tS_> u m i
tintswalo	t_> i n tS_> w a l O
tinwana	t_> i n w a n a
tinwani	t_> i n w a n i
tinwheti	t_> i n w h\ E t_> i
tinxaka	t_> i n S a k a
tinxakanxaka	t_> i n S a k a n S a k a
tinxakaxaka	t_> i n S a k a S a k a
tinyala	t_> i J a l a
tinyarhi	t_> i J a rh\ i
tinyawa	t_> i J a w a
tinyeleti	t_> i J E l E t_> i
tinyenyani	t_> i J E J a n i
tinyika	t_> i J i k a
tinyike	t_> i J i k E
tinyikela	t_> i J i k E l a
tinyikele	t_> i J i k E l E
tinyiketaka	t_> i J i k E t_> a k a
tinyikile	t_> i J i k i l E
tinyiko	t_> i J i k O
tinyimpi	t_> i J i m p i
tinyingi	t_> i J i N g i
tinyoka	t_> i J O k a
tinyungubyisa	t_> i J u N g u bj i s a
tinyungubyiseni	t_> i J u N g u bj i s E n i
tiolola	t_> i O l O l a
tiololi	t_> i O l O l i
tipala	t_> i p a l a
tipenda	t_> i p E n d a
tipepe	t_> i p E p E
tiphala	t_> i p_h a l a
tipharagirafu	t_> i p_h a r a g i r a f u
tiphesente	t_> i p_h E s E n t_> E
tiphina	t_> i p_h i n a
tiphini	t_> i p_h i n i
tipholisi	t_> i p_h O l i s i
tipolotiki	t_> i p O l O t_> i k i
tipopayi	t_> i p O p a j i
tiporompita	t_> i p O r O m p i t_> a
tiporopita	t_> i p O r O p i t_> a
tipulani	t_> i p u l a n i
tiqambhi	t_> i !\ a m b i
tiqingho	t_> i !\ i N gh\ O
tiradiyo	t_> i r a d i j O
tiranga	t_> i r a N g a
tirha	t_> i rh\ a
tirhaka	t_> i rh\ a k a
tirhako	t_> i rh\ a k O
tirhandza	t_> i rh\ a n' dz` a
tirhangi	t_> i rh\ a N g i
tirheka	t_> i rh\ E k a
tirheke	t_> i rh\ E k E
tirheki	t_> i rh\ E k i
tirhela	t_> i rh\ E l a
tirhelaku	t_> i rh\ E l a k u
tirhelo	t_> i rh\ E l O
tirheni	t_> i rh\ E n i
tirheriwaka	t_> i rh\ E r i w a k a
tirhi	t_> i rh\ i
tirhikhodo	t_> i rh\ i k_h O d O
tirhiku	t_> i rh\ i k u
tirhisa	t_> i rh\ i s a
tirhisaka	t_> i rh\ i s a k a
tirhisana	t_> i rh\ i s a n a
tirhisekaku	t_> i rh\ i s E k a k u
tirhiseriwa	t_> i rh\ i s E r i w a
tirhisile	t_> i rh\ i s i l E
tirhisiw	t_> i rh\ i s i w
tirhisiwa	t_> i rh\ i s i w a
tirhisiwaka	t_> i rh\ i s i w a k a
tirhisiwaku	t_> i rh\ i s i w a k u
tirhisiwangi	t_> i rh\ i s i w a N g i
tirhisiweke	t_> i rh\ i s i w E k E
tirhisiweni	t_> i rh\ i s i w E n i
tirhisiwi	t_> i rh\ i s i w i
tirhisiwile	t_> i rh\ i s i w i l E
tirhiswa	t_> i rh\ i s` a
tirhoboto	t_> i rh\ O b_< O t_> O
tirhoko	t_> i rh\ O k O
tirisa	t_> i r i s a
tiro	t_> a r O
tiro	t_> i r O
tisa	t_> i s a
tisaekile	t_> i s a E k i l E
tisandals	t_> i s a n d a l s
tisayizi	t_> i s a j i z i
tisela	t_> i s E l a
tisile	t_> i s i l E
tisimu	t_> i s i m u
tisirhelela	t_> i s i rh\ E l E l a
tisirheleli	t_> i s i rh\ E l E l i
tisisiteme	t_> i s i s i t_> E m E
tisisteme	t_> i s i s t_> E m E
tisiwa	t_> i s i w a
tisiwile	t_> i s i w i l E
tisola	t_> i s O l a
titanghu	t_> i t_> a N gh\ u
titatlangiwa	t_> i t_> a tl_> a N g i w a
titeki	t_> i t_> E k i
titele	t_> i t_> E l E
titimela	t_> i t_> i m E l a
titivisa	t_> i t_> i B i s a
titlanga	t_> i tl_> a N g a
titlhela	t_> i tl_h E l a
titombhi	t_> i t_> O m b i
titsarisa	t_> i tS_> a r i s a
titshava	t_> i tS_h a B a
titsongahata	t_> i tS_> O N g a h\ a t_> a
titsongo	t_> i tS_> O N g O
titwa	t_> i t_> w a
titwangi	t_> i t_> w a N g i
tiva	t_> i B a
tivaka	t_> i B a k a
tivaneni	t_> i B a n E n i
tivanga	t_> i B a N g a
tivanisa	t_> i B a n i s a
tive	t_> i B E
tiveji	t_> i B E d_0Z i
tiveka	t_> i B E k a
tivekaka	t_> i B E k a k a
tiveki	t_> i B E k i
tivekiki	t_> i B E k i k i
tivi	t_> i B i
tivisa	t_> i B i s a
tivisile	t_> i B i s i l E
tivisiwa	t_> i B i s i w a
tivisiwaka	t_> i B i s i w a k a
tivisiwi	t_> i B i s i w i
tivisiwile	t_> i B i s i w i l E
tiviwa	t_> i B i w a
tivona	t_> i B O n a
tivumbela	t_> i B u m b E l a
tivuxaka	t_> i B u S a k a
tiwadi	t_> i w a d i
tixaka	t_> i S a k a
tixakaxaka	t_> i S a k a S a k a
tiya	t_> i j a
tiyanga	t_> i j a N g a
tiyani	t_> i j a n i
tiyela	t_> i j E l a
tiyelanga	t_> i j E l a N g a
tiyelangi	t_> i j E l a N g i
tiyelela	t_> i j E l E l a
tiyile	t_> i j i l E
tiyimeleke	t_> i j i m E l E k E
tiyimelela	t_> i j i m E l E l a
tiyimisela	t_> i j i m i s E l a
tiyindlu	t_> i j i n dK u
tiyisa	t_> i j i s a
tiyisaka	t_> i j i s a k a
tiyiseka	t_> i j i s E k a
tiyisile	t_> i j i s i l E
tiyisisa	t_> i j i s i s a
tiyisisaka	t_> i j i s i s a k a
tiyisisiwa	t_> i j i s i s i w a
tiyisisiweke	t_> i j i s i s i w E k E
tiyisisiwile	t_> i j i s i s i w i l E
tiyisiwa	t_> i j i s i w a
tiyuniti	t_> i j u n i t_> i
tlakuka	tl_> a k u k a
tlakukile	tl_> a k u k i l E
tlakula	tl_> a k u l a
tlakusa	tl_> a k u s a
tlakuse	tl_> a k u s E
tlakusiwa	tl_> a k u s i w a
tlanga	tl_> a N g a
tlangandla	tl_> a N g a n dK a
tlangela	tl_> a N g E l a
tlangelasiku	tl_> a N g E l a s i k u
tlangeni	tl_> a N g E n i
tlangeriwa	tl_> a N g E r i w a
tlangeriwaubyeni	tl_> a N g E r i w a u bj E n i
tlangeriwi	tl_> a N g E r i w i
tlangi	tl_> a N g i
tlangisa	tl_> a N g i s a
tlangiwa	tl_> a N g i w a
tlangu	tl_> a N g u
tlantswa	tl_> a n tS_> w a
tleketla	tl_> E k E tl_> a
tlela	tl_> E l a
tlele	tl_> E l E
tleletla	tl_> E l E tl_> a
tlerisa	tl_> E r i s a
tleriwa	tl_> E r i w a
tlhariha	tl_h a r i h\ a
tlharihangi	tl_h a r i h\ a N g i
tlharihisa	tl_h a r i h\ i s a
tlharihisiwa	tl_h a r i h\ i s i w a
tlhava	tl_h a B a
tlhaveriwa	tl_h a B E r i w a
tlhaviwa	tl_h a B i w a
tlhavula	tl_h a B u l a
tlhavuriwa	tl_h a B u r i w a
tlhela	tl_h E l a
tlhelari	tl_h E l a r i
tlhelo	tl_h E l O
tlherisela	tl_h E r i s E l a
tlheriseli	tl_h E r i s E l i
tlheriseriwa	tl_h E r i s E r i w a
tlhontlha	tl_h O n tl_h a
tlhumile	tl_h u m i l E
tlimba	tl_> i m b a
tloyila	tl_> O j i l a
tlukwa	tl_> u k w a
tlula	tl_> u l a
tlule	tl_> u l E
tluliki	tl_> u l i k i
tlunya	tl_> u J a
tlurisa	tl_> u r i s a
tlurisisa	tl_> u r i s i s a
tluriwa	tl_> u r i w a
tluriwi	tl_> u r i w i
to	t_> O
to	t_> u
tola	t_> O l a
tolo	t_> O l O
toloki	t_> O l O k i
tolovela	t_> O l O B E l a
tolovelekanga	t_> O l O B E l E k a N g a
tolovelekangi	t_> O l O B E l E k a N g i
tolovelekangiki	t_> O l O B E l E k a N g i k i
toloveleki	t_> O l O B E l E k i
tolweni	t_> O l w E n i
tona	t_> O n a
tonnwini	t_> O n n w i n i
took	t_> O O k
took	t_> u k
torha	t_> O rh\ a
tori	t_> O r i
total	t_> O t_> a l
total	t_> O t_> E l
totala	t_> O t_> a l a
tournament	t_> O n E m E n t_>
tournament	t_> O u r n a m E n t_>
town	t_> a n
town	t_> O w n
trade	t_> r a d E
trade	t_> r E d
traditional	t_> r a d i t_> i O n a l
traditional	t_> r E d i s E n E l
treaty	t_> r E a tj
treaty	t_> r i t_> i
try	t_> r
try	t_> r a
tsaka	tS_> a k a
tsakama	tS_> a k a m a
tsakamile	tS_> a k a m i l E
tsakamisa	tS_> a k a m i s a
tsakela	tS_> a k E l a
tsakelaka	tS_> a k E l a k a
tsakisa	tS_> a k i s a
tsakisaku	tS_> a k i s a k u
tsakisi	tS_> a k i s i
tsakisiwahi	tS_> a k i s i w a h\ i
tsakiwa	tS_> a k i w a
tsala	tS_> a l a
tsalatsariwa	tS_> a l a tS_> a r i w a
tsale	tS_> a l E
tsaleka	tS_> a l E k a
tsaleke	tS_> a l E k E
tsalela	tS_> a l E l a
tsalele	tS_> a l E l E
tsaleriwa	tS_> a l E r i w a
tsaliwanga	tS_> a l i w a N g a
tsalwa	tS_> a l w a
tsana	tS_> a n a
tsandeka	tS_> a n d E k a
tsandzeka	tS_> a n' dz` E k a
tsandzekaka	tS_> a n' dz` E k a k a
tsandzekaku	tS_> a n' dz` E k a k u
tsandzekile	tS_> a n' dz` E k i l E
tsandzileswa	tS_> a n' dz` i l E s` a
tsandziwi	tS_> a n' dz` i w i
tsanile	tS_> a n i l E
tsanwisi	tS_> a n w i s i
tsara	tS_> a r a
tsarilo	tS_> a r i l O
tsarisa	tS_> a r i s a
tsarisiwa	tS_> a r i s i w a
tsarisiweke	tS_> a r i s i w E k E
tsariwa	tS_> a r i w a
tsariwangi	tS_> a r i w a N g i
tsariweke	tS_> a r i w E k E
tsariwile	tS_> a r i w i l E
tsavula	tS_> a B u l a
tsayiteli	tS_> a j i t_> E l i
tsekatseka	tS_> E k a tS_> E k a
tseleka	tS_> E l E k a
tselekangi	tS_> E l E k a N g i
tsema	tS_> E m a
tsemakanya	tS_> E m a k a J a
tsemelela	tS_> E m E l E l a
tsemeleriwa	tS_> E m E l E r i w a
tsemetiwa	tS_> E m E t_> i w a
tsemiwa	tS_> E m i w a
tsevu	tS_> E B u
tshaha	tS_h a h\ a
tshama	tS_h a m a
tshamaka	tS_h a m a k a
tshamaku	tS_h a m a k u
tshame	tS_h a m E
tshameke	tS_h a m E k E
tshamela	tS_h a m E l a
tshamile	tS_h a m i l E
tshamisa	tS_h a m i s a
tshamiseka	tS_h a m i s E k a
tshamisekile	tS_h a m i s E k i l E
tshana	tS_h a n a
tshanga	tS_h a N g a
tshava	tS_h a B a
tshemba	tS_h E m b a
tshembekanga	tS_h E m b E k a N g a
tshembele	tS_h E m b E l E
tshembisi	tS_h E m b i s i
tsheve	tS_h E B E
tshika	tS_h i k a
tshikele	tS_h i k E l E
tshikelelo	tS_h i k E l E l O
tshikeleriwa	tS_h i k E l E r i w a
tshikileriwile	tS_h i k i l E r i w i l E
tshinelela	tS_h i n E l E l a
tshopi	tS_h O p i
tshoveriweke	tS_h O B E r i w E k E
tshovi	tS_h O B i
tshuka	tS_h u k a
tshuki	tS_h u k i
tshulela	tS_h u l E l a
tshungeni	tS_h u N g E n i
tshungula	tS_h u N g u l a
tshuxeko	tS_h u S E k O
tshwa	tS_h w a
tshwane	tS_h w a n E
tshwile	tS_h w i l E
tshwini	tS_h w i n i
tshwuka	tS_h w u k a
tsindzemba	tS_> i n' dz` E m b a
tsindziyerile	tS_> i n' dz` i j E r i l E
tsokombela	tS_> O k O m b E l a
tsonga	tS_> O N g a
tsotsi	tS_> O tS_> i
tstutsuma	tS_> t_> u tS_> u m a
tsundzuka	tS_> u n' dz` u k a
tsundzuxa	tS_> u n' dz` u S a
tsutsuma	tS_> u tS_> u m a
tsutsumisa	tS_> u tS_> u m i s a
tsutsumisiwa	tS_> u tS_> u m i s i w a
tsuvuriwa	tS_> u B u r i w a
tsuvuriwi	tS_> u B u r i w i
tswala	tS_> w a l a
tswaleriwa	tS_> w a l E r i w a
tswali	tS_> w a l i
tswarisa	tS_> w a r i s a
tswariwa	tS_> w a r i w a
tswiyota	tS_> w i j O t_> a
tumbuluka	t_> u m b u l u k a
tumbuluke	t_> u m b u l u k E
tumbuluxa	t_> u m b u l u S a
tumbuluxile	t_> u m b u l u S i l E
tumbuluxiwa	t_> u m b u l u S i w a
tumbuluxiwe	t_> u m b u l u S i w E
tumbuluxiweke	t_> u m b u l u S i w E k E
tumbuluxiwile	t_> u m b u l u S i w i l E
turhisiwa	t_> u rh\ i s i w a
tv	t_> B
tv	t_> i v i
twa	t_> w a
twakalaka	t_> w a k a l a k a
twala	t_> w a l a
twalaka	t_> w a l a k a
twali	t_> w a l i
twanana	t_> w a n a n a
twanananiweke	t_> w a n a n a n i w E k E
twananiwa	t_> w a n a n i w a
twananiweke	t_> w a n a n i w E k E
twisa	t_> w i s a
twisakaswona	t_> w i s a k a s` O n a
twisisa	t_> w i s i s a
twisisaka	t_> w i s i s a k a
twisiseka	t_> w i s i s E k a
twisisekaka	t_> w i s i s E k a k a
twisisekeki	t_> w i s i s E k E k i
twisiseki	t_> w i s i s E k i
twisisi	t_> w i s i s i
twisisile	t_> w i s i s i l E
two	t_> u
two	t_> w O
types	t_> a p s
types	tj p E s
u	j u
uba	u b a
udya	u dj a
uendla	u E n dK a
uhlanganisa	u K a N g a n i s a
ukarhi	u k a rh\ i
ukota	u k O t_> a
uku	u k u
ukuya	u k u j a
ulava	u l a B a
ule	u l E
ulilisa	u l i l i s a
ulitshwayo	u l i tS_h w a j O
ulo	u l O
ulu	u l u
umahlangu	u m a K a N g u
umanyi	u m a J i
umsana	u m s a n a
umvumi	u m B u m i
umvumo	u m B u m O
un	u n
una	u n a
undleriwa	u n dK E r i w a
undzi	u n' dz` i
unendima	u n E n d i m a
unga	u N g a
ungase	u N g a s E
ungataswihheta	u N g a t_> a s` i h\ h\ E t_> a
ungayi	u N g a j i
unge	u N g E
ungeti	u N g E t_> i
uni	u n i
union	j u n E n
union	u n i O n
united	j u n a t_> E d
united	u n i t_> E d
unothembi	u n O t_h E m b i
unwana	u n w a n a
unwe	u n w E
urhandza	u rh\ a n' dz` a
urhunga	u rh\ u N g a
urini	u r i n i
uriwantima	u r i w a n t_> i m a
us	a s
us	u s
user	j u z E r
user	u s E r
ut	u t_>
uta	u t_> a
utava	u t_> a B a
uvavisekile	u B a B i s E k i l E
uvelekiwile	u B E l E k i w i l E
uvona	u B O n a
uwu	u w u
uya	u j a
uyawela	u j a w E l a
uyi	u j i
va	B a
vaaka	B a a k a
vaakatiko	B a a k a t_> i k O
vaaki	B a a k i
vaambala	B a a m b a l a
vaamukeri	B a a m u k E r i
vaarabhu	B a a r a b u
vabohiwa	B a b O h\ i w a
vabvana	B a b v a n a
vabya	B a bj a
vabyali	B a bj a l i
vabyi	B a bj i
vabyisa	B a bj i s a
vachayeri	B a tS_h a j E r i
vachuchisi	B a tS_h u tS_h i s i
vadlaya	B a dK a j a
vadya	B a dj a
vadyaberi	B a dj a b E r i
vadyahlampfi	B a dj a K a m p f i
vadyi	B a dj i
vadyondzi	B a dj O n' dz` i
vadyondzisi	B a dj O n' dz` i s i
vadyuharhi	B a dj u h\ a rh\ i
vadyuhari	B a dj u h\ a r i
vadzaberi	B a dz` a b E r i
vadzunisi	B a dz` u n i s i
vaendli	B a E n dK i
vaenili	B a E n i l i
vafambisi	B a f a m b i s i
vafana	B a f a n a
vaha	B a h\ a
vahariva	B a h\ a r i B a
vahhashi	B a h\ h\ a S i
vahhuma	B a h\ h\ u m a
vahi	B a h\ i
vahlaleri	B a K a l E r i
vahlamberi	B a K a m b E r i
vahlampfa	B a K a m p f a
vahlanganisi	B a K a N g a n i s i
vahlateri	B a K a t_> E r i
vahlayi	B a K a j i
vahlayisa	B a K a j i s a
vahlayisi	B a K a j i s i
vahlayisiwa	B a K a j i s i w a
vahleleri	B a K E l E r i
vahlengani	B a K E N g a n i
vahloti	B a K O t_> i
vahnu	B a h\ n u
vaholobye	B a h\ O l O bj E
vahoxi	B a h\ O S i
vahundzuluxeri	B a h\ u n' dz` u l u S E r i
vaka	B a k a
vakabhila	B a k a b i l a
vakahhina	B a k a h\ h\ i n a
vakakhosa	B a k a k_h O s a
vakala	B a k a l a
vakangomana	B a k a N g O m a n a
vakarhatekile	B a k a rh\ a t_> E k i l E
vakhalabya	B a k_h a l a bj a
vakhale	B a k_h a l E
vakhandziyi	B a k_h a n' dz` i j i
vakhegula	B a k_h E g u l a
vakhenghula	B a k_h E N gh\ u l a
vakhomba	B a k_h O m b a
vakhongeri	B a k_h O N g E r i
vakokwana	B a k O k w a n a
vakokwani	B a k O k w a n i
vakota	B a k O t_> a
vakreste	B a k r E s t_> E
vakumeka	B a k u m E k a
vakumile	B a k u m i l E
vakurisi	B a k u r i s i
vakwapa	B a k w a p a
vakwe	B a k w E
valahlekeriwile	B a l a K E k E r i w i l E
valava	B a l a B a
valavisisi	B a l a B i s i s i
vale	B a l E
vale	v E l
valungu	B a l u N g u
valungwini	B a l u N g w i n i
valwela	B a l w E l a
valweri	B a l w E r i
vamabindzu	B a m a b i n' dz` u
vamajisitarata	B a m a d_0Z i s i t_> a r a t_> a
vamana	B a m a n a
vamanana	B a m a n a n a
vamasipala	B a m a s i p a l a
vamatiko	B a m a t_> i k O
vamatlharhi	B a m a tl_h a rh\ i
vambale	B a m b a l E
vambarile	B a m b a r i l E
vambe	B a m b E
vambirhi	B a m b i rh\ i
vambiwile	B a m b i w i l E
van	B a n
van	v a n
vana	B a n a
vananga	B a n a N g a
vanatwanano	B a n a t_> w a n a n O
vandla	B a n dK a
vanga	B a N g a
vangaka	B a N g a k a
vangama	B a N g a m a
vangela	B a N g E l a
vangenisa	B a N g E n i s a
vangeriweke	B a N g E r i w E k E
vanghana	B a N gh\ a n a
vanghenisa	B a N gh\ E n i s a
vanghenisi	B a N gh\ E n i s i
vangiwa	B a N g i w a
vangoni	B a N g O n i
vanhlonge	B a n K O N g E
vanhu	B a n_h u
vanhwana	B a n_h w a n a
vanhwanyani	B a n_h w a J a n i
vanhwini	B a n_h w i n i
vani	B a n i
vantima	B a n t_> i m a
vantshwa	B a n tS_h w a
vantswa	B a n tS_> w a
vanu	B a n u
vanuna	B a n u n a
vanwa	B a n w a
vanwama	B a n w a m a
vanwamatiko	B a n w a m a t_> i k O
vanwana	B a n w a n a
vanwani	B a n w a n i
vanwankumi	B a n w a n k u m i
vanyanyuri	B a J a J u r i
vanyiki	B a J i k i
vaofisiri	B a O f i s i r i
vaongori	B a O N g O r i
vaonheriwa	B a O n_h E r i w a
vapfhumba	B a p f h\ u m b a
vapfumari	B a p f u m a r i
vapfumeri	B a p f u m E r i
vapfuni	B a p f u n i
vaphakeri	B a p_h a k E r i
vaphasi	B a p_h a s i
vaphikizani	B a p_h i k i z a n i
vaphurofexinali	B a p_h u r O f E S i n a l i
varandza	B a r a n' dz` a
varandzani	B a r a n' dz` a n i
varandziwa	B a r a n' dz` i w a
varhandza	B a rh\ a n' dz` a
varhangeri	B a rh\ a N g E r i
varhangi	B a rh\ a N g i
varisi	B a r i s i
varona	B a r O n a
vasari	B a s a r i
vasati	B a s a t_> i
vasco	B a s tS_> O
vaseketeri	B a s E k E t_> E r i
vasesi	B a s E s i
vashavi	B a S a B i
vashavisa	B a S a B i s a
vashavisi	B a S a B i s i
vasi	B a s i
vaswi	B a s` i
vata	B a t_> a
vatekani	B a t_> E k a n i
vathekiniki	B a t_h E k i n i k i
vathori	B a t_h O r i
vati	B a t_> i
vatifilimu	B a t_> i f i l i m u
vatirhela	B a t_> i rh\ E l a
vatirhelamfumo	B a t_> i rh\ E l a m f u m O
vatirhi	B a t_> i rh\ i
vatirhisi	B a t_> i rh\ i s i
vativi	B a t_> i B i
vativiwa	B a t_> i B i w a
vatla	B a tl_> a
vatlanga	B a tl_> a N g a
vatlangi	B a tl_> a N g i
vatlangu	B a tl_> a N g u
vatleka	B a tl_> E k a
vatlekile	B a tl_> E k i l E
vatliwa	B a tl_> i w a
vatoyota	B a t_> O j O t_> a
vatsakela	B a tS_> a k E l a
vatsama	B a tS_> a m a
vatsari	B a tS_> a r i
vatshafa	B a tS_h a f a
vatshayi	B a tS_h a j i
vatsona	B a tS_> O n a
vatsonga	B a tS_> O N g a
vatsongamachangana	B a tS_> O N g a m a tS_h a N g a n a
vatsundzuxi	B a tS_> u n' dz` u S i
vatswari	B a tS_> w a r i
vava	B a B a
vavabyi	B a B a bj i
vavantima	B a B a n t_> i m a
vavanuna	B a B a n u n a
vavasati	B a B a s a t_> i
vavasativa	B a B a s a t_> i B a
vavatli	B a B a tl_> i
vaviseka	B a B i s E k a
vavisekaka	B a B i s E k a k a
vavisekaku	B a B i s E k a k u
vavisekile	B a B i s E k i l E
vaviwa	B a B i w a
vavulavula	B a B u l a B u l a
vavulavuri	B a B u l a B u r i
vavuyimbeleri	B a B u j i m b E l E r i
vaxava	B a S a B a
vaxavi	B a S a B i
vaxavis	B a S a B i s
vaxavisi	B a S a B i s i
vaxikolo	B a S i k O l O
vaxisati	B a S i s a t_> i
vaya	B a j a
vayile	B a j i l E
vayimbelela	B a j i m b E l E l a
vayimbeleri	B a j i m b E l E r i
vayimeri	B a j i m E r i
vayingiseri	B a j i N g i s E r i
ve	B E
veka	B E k a
veke	B E k E
vekela	B E k E l a
vekeriwa	B E k E r i w a
vekisa	B E k i s a
vekiwa	B E k i w a
vekiweke	B E k i w E k E
vele	B E l E
veleka	B E l E k a
veleke	B E l E k E
veleki	B E l E k i
velekiwa	B E l E k i w a
velekiwaka	B E l E k i w a k a
velekiwe	B E l E k i w E
venga	B E N g a
version	B E r s i O n
version	v a s E n
vevuka	B E B u k a
vhanicara	v a n i tS_> a r a
vhengele	v E N g E l E
vhengeleni	v E N g E l E n i
vhikela	v i k E l a
vhiki	v i k i
vhota	v O t_> a
vhoteni	v O t_> E n i
vhumbhi	v u m b i
vi	B i
vika	B i k a
vikiwa	B i k i w a
vile	B i l E
vile	v a l
vindluka	B i n dK u k a
virisa	B i r i s a
vitana	B i t_> a n a
vito	B i t_> O
vo	B O
vobasa	B O b_< a s a
vobhasa	B O b a s a
vohla	B O K a
voka	B O k a
voko	B O k O
vona	B O n a
vonaka	B O n a k a
vonakaka	B O n a k a k a
vonani	B O n a n i
vondziwa	B O n' dz` i w a
vondzoka	B O n' dz` O k a
voneka	B O n E k a
vonela	B O n E l a
vonelo	B O n E l O
voneni	B O n E n i
voni	B O n i
voninga	B O n i N g a
vonisa	B O n i s a
vonisisa	B O n i s i s a
voniwa	B O n i w a
voniwaka	B O n i w a k a
voniwe	B O n i w E
vonsni	B O n s n i
votala	B O t_> a l a
voted	B O t_> E d
voted	v O t_> E d
vothiwe	B O t_h i w E
votsutsuma	B O tS_> u tS_> u m a
voya	B O j a
vu	B u
vu	v a u
vuakatiko	B u a k a t_> i k O
vuangarheli	B u a N g a rh\ E l i
vuavanyisi	B u a B a J i s i
vubihi	B u b i h\ i
vuchayeri	B u tS_h a j E r i
vudyandzhaka	B u dj a n' dz`h\ a k a
vudyeledyele	B u dj E l E dj E l E
vudyoho	B u dj O h\ O
vudyondzi	B u dj O n' dz` i
vuenti	B u E n t_> i
vufambisi	B u f a m b i s i
vufuvi	B u f u B i
vufuwi	B u f u w i
vugangu	B u g a N g u
vugembuli	B u g E m b u l i
vugevenga	B u g E B E N g a
vugevhenga	B u g E v E N g a
vugono	B u g O n O
vuhandzuri	B u h\ a n' dz` u r i
vuhaxi	B u h\ a S i
vuhhashi	B u h\ h\ a S i
vuhhumajambu	B u h\ h\ u m a d_0Z a m b u
vuhlalu	B u K a l u
vuhlamberi	B u K a m b E r i
vuhlampfa	B u K a m p f a
vuhlanganisi	B u K a N g a n i s i
vuhlangi	B u K a N g i
vuhlayi	B u K a j i
vuhlayiseki	B u K a j i s E k i
vuhlayiselo	B u K a j i s E l O
vuhosi	B u h\ O s i
vuhoxaxandla	B u h\ O S a S a n dK a
vuhoxelo	B u h\ O S E l O
vuhungasi	B u h\ u N g a s i
vukanyi	B u k a J i
vukarhi	B u k a rh\ i
vukati	B u k a t_> i
vukele	B u k E l E
vukhale	B u k_h a l E
vukhamba	B u k_h a m b a
vukheta	B u k_h E t_> a
vukhomba	B u k_h O m b a
vukhongeli	B u k_h O N g E l i
vukhongerhi	B u k_h O N g E rh\ i
vukhongeri	B u k_h O N g E r i
vukhume	B u k_h u m E
vukorhokeri	B u k O rh\ O k E r i
vukulu	B u k u l u
vukungumbyana	B u k u N g u m bj a n a
vukungundwana	B u k u N g u n d w a n a
vukungundwani	B u k u N g u n d w a n i
vula	B u l a
vulahuri	B u l a h\ u r i
vulanguteri	B u l a N g u t_> E r i
vulavula	B u l a B u l a
vulavulaka	B u l a B u l a k a
vulavuleni	B u l a B u l E n i
vulavurisana	B u l a B u r i s a n a
vulavuriwa	B u l a B u r i w a
vulavuriwaka	B u l a B u r i w a k a
vulawuli	B u l a w u l i
vulawuri	B u l a w u r i
vulehi	B u l E h\ i
vulelo	B u l E l O
vuleteri	B u l E t_> E r i
vuli	B u l i
vulombe	B u l O m b E
vulongo	B u l O N g O
vulongoloxamarito	B u l O N g O l O S a m a r i t_> O
vululami	B u l u l a m i
vululamisi	B u l u l a m i s i
vulungu	B u l u N g u
vulyi	B u l i
vuma	B u m a
vumaki	B u m a k i
vumba	B u m b a
vumbano	B u m b a n O
vumbetela	B u m b E t_> E l a
vumbhoni	B u m b O n i
vumbirhi	B u m b i rh\ i
vumbiwa	B u m b i w a
vumbiwile	B u m b i w i l E
vumune	B u m u n E
vumunhu	B u m u n_h u
vun	B u n
vunanga	B u n a N g a
vundzeni	B u n' dz` E n i
vunene	B u n E n E
vunghwazi	B u N gh\ w a z i
vunharhu	B u n_h a rh\ u
vunhlori	B u n K O r i
vuntshwa	B u n tS_h w a
vununa	B u n u n a
vununga	B u n u N g a
vunyiki	B u J i k i
vunyingi	B u J i N g i
vuolori	B u O l O r i
vuoswi	B u O s` i
vupela	B u p E l a
vupfa	B u p f a
vupfhumba	B u p f h\ u m b a
vupfile	B u p f i l E
vupfumalantirho	B u p f u m a l a n t_> i rh\ O
vupfuneti	B u p f u n E t_> i
vuphisa	B u p_h i s a
vuphorisa	B u p_h O r i s a
vuphorisasa	B u p_h O r i s a s a
vupulani	B u p u l a n i
vuputsu	B u p u tS_> u
vurhangeli	B u rh\ a N g E l i
vurhangeri	B u rh\ a N g E r i
vurhena	B u rh\ E n a
vurhon	B u rh\ O n
vurhonga	B u rh\ O N g a
vurhongo	B u rh\ O N g O
vurhungi	B u rh\ u N g i
vurimi	B u r i m i
vuriso	B u r i s O
vuriwa	B u r i w a
vuriwaka	B u r i w a k a
vuriweke	B u r i w E k E
vusati	B u s a t_> i
vushavisi	B u S a B i s i
vusiku	B u s i k u
vusirheleleki	B u s i rh\ E l E l E k i
vusirheleri	B u s i rh\ E l E r i
vusiwana	B u s i w a n a
vusokoti	B u s O k O t_> i
vusw	v u E s d a b E l j u
vuswa	B u s` a
vusweti	B u s` E t_> i
vuswikoti	B u s` i k O t_> i
vuta	B u t_> a
vuthu	B u t_h u
vutihlamuleri	B u t_> i K a m u l E r i
vutiolori	B u t_> i O l O r i
vutireli	B u t_> i r E l i
vutirheli	B u t_> i rh\ E l i
vutisa	B u t_> i s a
vutisiweke	B u t_> i s i w E k E
vutitivisi	B u t_> i t_> i B i s i
vutitshembi	B u t_> i tS_h E m b i
vutitumbuluxeri	B u t_> i t_> u m b u l u S E r i
vutivi	B u t_> i B i
vutleketli	B u tl_> E k E tl_> i
vutlharhi	B u tl_h a rh\ i
vutlhari	B u tl_h a r i
vutlhokovetseri	B u tl_h O k O B E tS_> E r i
vutlukwa	B u tl_> u k w a
vutom	B u t_> O m
vutomi	B u t_> O m i
vutomini	B u t_> O m i n i
vutsari	B u tS_> a r i
vutshamo	B u tS_h a m O
vutshayi	B u tS_h a j i
vutshila	B u tS_h i l a
vutsokovetseri	B u tS_> O k O B E tS_> E r i
vutsotsi	B u tS_> O tS_> i
vuvabyi	B u B a bj i
vuvambi	B u B a m b i
vuvatli	B u B a tl_> i
vuveki	B u B E k i
vuvekisi	B u B E k i s i
vuvulavuri	B u B u l a B u r i
vuxadyambu	B u S a dj a m b u
vuxaka	B u S a k a
vuxeni	B u S E n i
vuxirho	B u S i rh\ O
vuxisi	B u S i s i
vuxokoxoko	B u S O k O S O k O
vuxongi	B u S O N g i
vuxoperi	B u S O p E r i
vuxungi	B u S u N g i
vuxungu	B u S u N g u
vuya	B u j a
vuyela	B u j E l a
vuyeleriwa	B u j E l E r i w a
vuyerisa	B u j E r i s a
vuyerisaka	B u j E r i s a k a
vuyeriwa	B u j E r i w a
vuyi	B u j i
vuyile	B u j i l E
vuyimana	B u j i m a n a
vuyimbeleri	B u j i m b E l E r i
vuyimberi	B u j i m b E r i
vuyimeri	B u j i m E r i
vuyisa	B u j i s a
vuyisela	B u j i s E l a
w	d a b E l j u
wa	w a
waafrika	w a a f r i k a
waafrikadzonga	w a a f r i k a dz` O N g a
waangola	w a a N g O l a
wabamhlophe	w a b a m K O p_h E
wabholo	w a b O l O
wabo	w a b O
wachina	w a tS_h i n a
wadayila	w a d a j i l a
wadi	O d a
wadi	w a d i
wajse	w a d_0Z s E
waka	w a k a
wakarati	w a k a r a t_> i
wakosobantu	w a k O s O b a n t_> u
waku	w a k u
wakumeka	w a k u m E k a
wakwe	w a k w E
wale	w a l E
wale	w E l
walehhansi	w a l E h\ h\ a n s i
waleshikarhi	w a l E S i k a rh\ i
walk	w a l k
walk	w O k
wall	w a l l
wall	w O l
wamafurha	w a m a f u rh\ a
wamalatino	w a m a l a t_> i n O
wamandlela	w a m a n dK E l a
wamatiko	w a m a t_> i k O
wamatimu	w a m a t_> i m u
wamavoko	w a m a B O k O
wamina	w a m i n a
wamisava	w a m i s a B a
wamitwa	w a m i t_> w a
wamtn	w a E m t_> i E n
wana	w a n a
wananga	w a n a N g a
wandlandlamuka	w a n dK a n dK a m u k a
wanga	w a N g a
wangulano	w a N g u l a n O
wansati	w a n s a t_> i
wantobileyi	w a n t_> O b i l E j i
wanuna	w a n u n a
war	w a r
war	w O r
waranti	w a r a n t_> i
was	w a s
was	w O z
wasi	w a s i
waterfall	w a t_> E r f a l l
waterfall	w O t_> E f O l
wathelevishini	w a t_h E l E B i S i n i
watiko	w a t_> i k O
watintshimi	w a t_> i n tS_h i m i
watitiamati	w a t_> i t_> i a m a t_> i
watsakisa	w a tS_> a k i s a
wava	w a B a
wavanhu	w a B a n_h u
wavantima	w a B a n t_> i m a
wavona	w a B O n a
wayi	w a j i
wayitela	w a j i t_> E l a
we	w E
we	w i
website	w E b s a t_>
website	w E b s i t_> E
wekhabo	w E k_h a b O
wela	w E l a
welawela	w E l a w E l a
wena	w E n a
werile	w E r i l E
west	w E s t_>
western	w E s t_> E n
western	w E s t_> E r n
when	w E n
when	w h\ E n
wheti	w h\ E t_> i
wi	w i
wihi	w i h\ i
wile	w a l
wile	w i l E
wili	w i l i
wina	w i n a
wini	w i n i
winile	w i n i l E
winyi	w i J i
wisa	w i s a
wise	w a z
wise	w i s E
wiseni	w i s E n i
wisisa	w i s i s a
wita	w i t_> a
wiwa	w i w a
wo	w O
woendla	w O E n dK a
woka	w O k a
woke	w O k
woke	w O k E
woleha	w O l E h\ a
wolow	w O l O w
wolowo	w O l O w O
wona	w O n a
wonge	w O N g E
wontima	w O n t_> i m a
works	w a k s
works	w O r k s
world	w a l d
world	w O r l d
worlds	w a l d z
worlds	w O r l d s
wosungula	w O s u N g u l a
woxe	w O S E
woyimbelela	w O j i m b E l E l a
writers	r a t_> E z
writers	w r i t_> E r s
wsitele	w s i t_> E l E
wu	w u
wudlaya	w u dK a j a
wudlaye	w u dK a j E
wukulu	w u k u l u
wukumeka	w u k u m E k a
wula	w u l a
wule	w u l E
wun	w u n
wuna	w u n a
wuni	w u n i
wuntshwa	w u n tS_h w a
wunwani	w u n w a n i
wunwe	w u n w E
wupfuna	w u p f u n a
wupfuniwa	w u p f u n i w a
wuri	w u r i
wutava	w u t_> a B a
wuya	w u j a
wuyisiwa	w u j i s i w a
x	E k s
xa	S a
xaha	S a h\ a
xahle	S a K E
xaka	S a k a
xakeva	S a k E B a
xakhale	S a k_h a l E
xakwe	S a k w E
xale	S a l E
xalehenhla	S a l E h\ E n K a
xalembe	S a l E m b E
xambila	S a m b i l a
xambile	S a m b i l E
xamisisi	S a m i s i s i
xana	S a n a
xandla	S a n dK a
xanga	S a N g a
xanisa	S a n i s a
xanisiwa	S a n i s i w a
xanisiwile	S a n i s i w i l E
xava	S a B a
xave	S a B E
xaveka	S a B E k a
xaveki	S a B E k i
xaveni	S a B E n i
xaveriwa	S a B E r i w a
xaveriwaka	S a B E r i w a k a
xaveriwile	S a B E r i w i l E
xavetela	S a B E t_> E l a
xavile	S a B i l E
xavisa	S a B i s a
xaviseka	S a B i s E k a
xavisela	S a B i s E l a
xaviselana	S a B i s E l a n a
xaviseriwa	S a B i s E r i w a
xavisiwa	S a B i s i w a
xavisiwaka	S a B i s i w a k a
xaviwa	S a B i w a
xaviwaka	S a B i w a k a
xaviweni	S a B i w E n i
xavo	S a B O
xavutomi	S a B u t_> O m i
xawula	S a w u l a
xaxameta	S a S a m E t_> a
xaxameti	S a S a m E t_> i
xedulu	S E d u l u
xele	S E l E
xemu	S E m u
xexo	S E S O
xi	S i
xiangu	S i a N g u
xiave	S i a B E
xibakabaka	S i b a k a b a k a
xibakele	S i b a k E l E
xibalo	S i b_< a l O
xibamu	S i b a m u
xibamubamu	S i b a m u b a m u
xibelana	S i b E l a n a
xibelani	S i b E l a n i
xibhelani	S i b E l a n i
xiboho	S i b O h\ O
xibokisana	S i b O k i s a n a
xibolwani	S i b O l w a n i
xibukwana	S i b u k w a n a
xibuna	S i b u n a
xibunu	S i b u n u
xiburukwani	S i b u r u k w a n i
xichangani	S i tS_h a N g a n i
xichava	S i tS_h a B a
xichaya	S i tS_h a j a
xiculu	S i tS_> u l u
xidimokirasi	S i d i m O k i r a s i
xidluka	S i dK u k a
xidyohi	S i dj O h\ i
xidyondzeki	S i dj O n' dz` E k i
xidzedze	S i dz` E dz` E
xiehlo	S i E K O
xiendla	S i E n dK a
xiendlahivom	S i E n dK a h\ i B O m
xiendlahivomu	S i E n dK a h\ i B O m u
xifaki	S i f a k i
xifamba	S i f a m b a
xifambo	S i f a m b O
xifaniso	S i f a n i s O
xifase	S i f a s E
xifufa	S i f u f a
xifundza	S i f u n' dz` a
xifundzankulu	S i f u n' dz` a n k u l u
xifundzankuluwa	S i f u n' dz` a n k u l u w a
xifundzantsongo	S i f u n' dz` a n tS_> O N g O
xifundzha	S i f u n' dz`h\ a
xifundzhankulu	S i f u n' dz`h\ a n k u l u
xifuveni	S i f u B E n i
xigandza	S i g a n' dz` a
xiganga	S i g a N g a
xigaza	S i g a z a
xigentle	S i g E n tl_> E
xighevenga	S i gh\ E B E N g a
xighila	S i gh\ i l a
xighubu	S i gh\ u b u
xigidana	S i g i d a n a
xigila	S i g i l a
xigilamikhuva	S i g i l a m i k_h u B a
xigombela	S i g O m b E l a
xigomelai	S i g O m E l a i
xigondo	S i g O n d O
xigubu	S i g u b u
xigugu	S i g u g u
xigulana	S i g u l a n a
xigwimbhi	S i g w i m b i
xigwitsirisi	S i g w i tS_> i r i s i
xihahampfhuka	S i h\ a h\ a m p f h\ u k a
xihahampfuka	S i h\ a h\ a m p f u k a
xihahati	S i h\ a h\ a t_> i
xihangu	S i h\ a N g u
xihatla	S i h\ a tl_> a
xihelekelo	S i h\ E l E k E l O
xihi	S i h\ i
xihimu	S i h\ i m u
xihlahla	S i K a K a
xihlambanyiso	S i K a m b a J i s O
xihlambanyo	S i K a m b a J O
xihlawu	S i K a w u
xihlawuhlawu	S i K a w u K a w u
xihlaya	S i K a j a
xihlayayisa	S i K a j a j i s a
xihlovo	S i K O B O
xihluke	S i K u k E
xihluvi	S i K u B i
xihoko	S i h\ O k O
xihontlovila	S i h\ O n tl_> O B i l a
xihoxo	S i h\ O S O
xihuhuri	S i h\ u h\ u r i
xihuku	S i h\ u k u
xihume	S i h\ u m E
xihundla	S i h\ u n dK a
xihungasi	S i h\ u N g a s i
xiisilamu	S i i s i l a m u
xijumba	S i d_0Z u m b a
xik	S i k
xikambelantwisiso	S i k a m b E l a n t_> w i s i s O
xikambelo	S i k a m b E l O
xikan	S i k a n
xikandza	S i k a n' dz` a
xikandziyisa	S i k a n' dz` i j i s a
xikanyakanya	S i k a J a k a J a
xikanyana	S i k a J a n a
xikarhi	S i k a rh\ i
xikatawa	S i k a t_> a w a
xikaya	S i k a j a
xikece	S i k E tS_> E
xikeche	S i k E tS_h E
xikepe	S i k E p E
xiketi	S i k E t_> i
xikhale	S i k_h a l E
xikhle	S i k_h K E
xikhoma	S i k_h O m a
xikhongelweni	S i k_h O N g E l w E n i
xikhumukani	S i k_h u m u k a n i
xikhwama	S i k_h w a m a
xikhwameni	S i k_h w a m E n i
xikhwanma	S i k_h w a n m a
xikimi	S i k i m i
xikipa	S i k i p a
xikolo	S i k O l O
xikolokhale	S i k O l O k_h a l E
xikoloxa	S i k O l O S a
xikolweni	S i k O l w E n i
xikomba	S i k O m b a
xikombankarhi	S i k O m b a n k a rh\ i
xikombelo	S i k O m b E l O
xikombisa	S i k O m b i s a
xikombiso	S i k O m b i s O
xikongelo	S i k O N g E l O
xikongomelo	S i k O N g O m E l O
xikoteleni	S i k O t_> E l E n i
xikufumeta	S i k u f u m E t_> a
xikumeka	S i k u m E k a
xikumiwile	S i k u m i w i l E
xikweleti	S i k w E l E t_> i
xikwembu	S i k w E m b u
xikwere	S i k w E r E
xilaveko	S i l a B E k O
xilawulantekelo	S i l a w u l a n t_> E k E l O
xile	S i l E
xileriso	S i l E r i s O
xiletelo	S i l E t_> E l O
xilipi	S i l i p i
xilo	S i l O
xilombe	S i l O m b E
xilotlela	S i l O tl_> E l a
xiluke	S i l u k E
xilungu	S i l u N g u
xilungwini	S i l u N g w i n i
xiluva	S i l u B a
ximanga	S i m a N g a
ximangava	S i m a N g a B a
ximanguva	S i m a N g u B a
ximanguvalawa	S i m a N g u B a l a w a
ximanjemanje	S i m a J d_0Z E m a J d_0Z E
ximanjhemanjhe	S i m a J dZh\ E m a J dZh\ E
ximatsatsa	S i m a tS_> a tS_> a
ximatsini	S i m a tS_> i n i
ximfumo	S i m f u m O
ximfumu	S i m f u m u
ximhakana	S i m_h a k a n a
ximilana	S i m i l a n a
ximumu	S i m u m u
ximunhu	S i m u n_h u
ximunhuhatwa	S i m u n_h u h\ a t_> w a
ximunhuhatwankulu	S i m u n_h u h\ a t_> w a n k u l u
ximunwana	S i m u n w a n a
ximunwani	S i m u n w a n i
ximuzilimi	S i m u z i l i m i
xin	S i n
xina	S i n a
xinari	S i n a r i
xinavetiso	S i n a B E t_> i s O
xinawana	S i n a w a n a
xinawu	S i n a w u
xincayincayi	S i n tS_> a j i n tS_> a j i
xinchalani	S i n tS_h a l a n i
xinefu	S i n E f u
xinene	S i n E n E
xinepe	S i n E p E
xinga	S i N g a
xingghezi	S i N g gh\ E z i
xingherile	S i N gh\ E r i l E
xinghezi	S i N gh\ E z i
xinghozi	S i N gh\ O z i
xinhombelani	S i n_h O m b E l a n i
xini	S i n i
xinkadyana	S i n k a dj a n a
xinkankanka	S i n k a n k a n k a
xinkarhana	S i n k a rh\ a n a
xinkwa	S i n k w a
xinkwamana	S i n k w a m a n a
xinto	S i n t_> O
xintshwa	S i n tS_h w a
xintsongo	S i n tS_> O N g O
xintu	S i n t_> u
xintwerere	S i n t_> w E r E r E
xinuna	S i n u n a
xinwana	S i n w a n a
xinwani	S i n w a n i
xinyami	S i J a m i
xinyata	S i J a t_> a
xinyenyani	S i J E J a n i
xioloko	S i O l O k O
xiove	S i O B E
xipandza	S i p a n' dz` a
xipandzamananga	S i p a n' dz` a m a n a N g a
xipano	S i p a n O
xipanu	S i p a n u
xipeceli	S i p E tS_> E l i
xipele	S i p E l E
xiphawo	S i p_h a w O
xiphaza	S i p_h a z a
xiphemu	S i p_h E m u
xiphemuntsongo	S i p_h E m u n tS_> O N g O
xiphemunyana	S i p_h E m u J a n a
xiphongo	S i p_h O N g O
xiphorisa	S i p_h O r i s a
xipikara	S i p i k a r a
xipinichi	S i p i n i tS_h i
xipinici	S i p i n i tS_> i
xipirimente	S i p i r i m E n t_> E
xiponci	S i p O n tS_> i
xipotoriya	S i p O t_> O r i j a
xipotsweni	S i p O tS_> w E n i
xiprofexini	S i p r O f E S i n i
xirapha	S i r a p_h a
xireresa	S i r E r E s a
xirhami	S i rh\ a m i
xirhangisi	S i rh\ a N g i s i
xirhasita	S i rh\ a s i t_> a
xirheche	S i rh\ E tS_h E
xirhendewutani	S i rh\ E n d E w u t_> a n i
xirhezani	S i rh\ E z a n i
xirho	S i rh\ O
xirhoma	S i rh\ O m a
xirhomberhombe	S i rh\ O m b E rh\ O m b E
xirhonkulu	S i rh\ O n k u l u
xirhundu	S i rh\ u n d u
xiri	S i r i
xiribyana	S i r i bj a n a
xiritwani	S i r i t_> w a n i
xirungulwana	S i r u N g u l w a n a
xisa	S i s a
xisaka	S i s a k a
xisandzu	S i s a n' dz` u
xisati	S i s a t_> i
xiseveseve	S i s E B E s E B E
xiseveseveni	S i s E B E s E B E n i
xisibi	S i s i b i
xisihalali	S i s i h\ a l a l i
xisihalari	S i s i h\ a l a r i
xisirhelelo	S i s i rh\ E l E l O
xisungla	S i s u N g l a
xiswathe	S i s` a t_h E
xiswona	S i s` O n a
xita	S i t_> a
xitachi	S i t_> a tS_h i
xitalo	S i t_> a l O
xitandani	S i t_> a n d a n i
xitanga	S i t_> a N g a
xitatimede	S i t_> a t_> i m E d E
xitatimende	S i t_> a t_> i m E n d E
xitatimendhe	S i t_> a t_> i m E n dh\ E
xitayele	S i t_> a j E l E
xitayili	S i t_> a j i l i
xiteji	S i t_> E d_0Z i
xitejini	S i t_> E d_0Z i n i
xiteka	S i t_> E k a
xitempe	S i t_> E m p E
xitetemba	S i t_> E t_> E m b a
xithekiniki	S i t_h E k i n i k i
xithifiketi	S i t_h i f i k E t_> i
xithifikheyiti	S i t_h i f i k_h E j i t_> i
xithuvi	S i t_h u B i
xitichi	S i t_> i tS_h i
xitici	S i t_> i tS_> i
xitifiketi	S i t_> i f i k E t_> i
xitifikheti	S i t_> i f i k_h E t_> i
xitifikheyiti	S i t_> i f i k_h E j i t_> i
xitimela	S i t_> i m E l a
xitimele	S i t_> i m E l E
xitirha	S i t_> i rh\ a
xitirho	S i t_> i rh\ O
xitiringi	S i t_> i r i N g i
xitiringo	S i t_> i r i N g O
xitirongo	S i t_> i r O N g O
xitiviso	S i t_> i B i s O
xitiya	S i t_> i j a
xitlhangu	S i tl_h a N g u
xitlhavelo	S i tl_h a B E l O
xitlhokovetselo	S i tl_h O k O B E tS_> E l O
xitofu	S i t_> O f u
xitokisi	S i t_> O k i s i
xitolo	S i t_> O l O
xitoporiya	S i t_> O p O r i j a
xitori	S i t_> O r i
xitsalu	S i tS_> a l u
xitsalwambiko	S i tS_> a l w a m b i k O
xitsalwana	S i tS_> a l w a n a
xitshopani	S i tS_h O p a n i
xitshunxo	S i tS_h u n S O
xitshuri	S i tS_h u r i
xitshuriw	S i tS_h u r i w
xitshuriwa	S i tS_h u r i w a
xitshwati	S i tS_h w a t_> i
xitsonga	S i tS_> O N g a
xitsongwatsongwana	S i tS_> O N g w a tS_> O N g w a n a
xitswiriri	S i tS_> w i r i r i
xitulu	S i t_> u l u
xitulwini	S i t_> u l w i n i
xitumbelelani	S i t_> u m b E l E l a n i
xitumbeta	S i t_> u m b E t_> a
xivambalani	S i B a m b a l a n i
xivandla	S i B a n dK a
xivangelo	S i B a N g E l O
xivelekelo	S i B E l E k E l O
xiviko	S i B i k O
xivilelo	S i B i l E l O
xivindzini	S i B i n' dz` i n i
xiviri	S i B i r i
xivonele	S i B O n E l E
xivongo	S i B O N g O
xivono	S i B O n O
xivula	S i B u l a
xivulavulelo	S i B u l a B u l E l O
xivulwa	S i B u l w a
xivumbeko	S i B u m b E k O
xivumbiwa	S i B u m b i w a
xivundza	S i B u n' dz` a
xivungu	S i B u N g u
xivuriso	S i B u r i s O
xivutiso	S i B u t_> i s O
xiwawa	S i w a w a
xiwethu	S i w E t_h u
xixaka	S i S a k a
xixevo	S i S E B O
xixika	S i S i k a
xixikana	S i S i k a n a
xixima	S i S i m a
xixita	S i S i t_> a
xixurhana	S i S u rh\ a n a
xiya	S i j a
xiyamimoya	S i j a m i m O j a
xiyani	S i j a n i
xiyanimoya	S i j a n i m O j a
xiyanimoyaxi	S i j a n i m O j a S i
xiyaxiya	S i j a S i j a
xiyengantsongo	S i j E N g a n tS_> O N g O
xiyenge	S i j E N g E
xiyengentsongo	S i j E N g E n tS_> O N g O
xiyeni	S i j E n i
xiyimbeleri	S i j i m b E l E r i
xiyimo	S i j i m O
xiyimu	S i j i m u
xiyisisa	S i j i s i s a
xiyisisisa	S i j i s i s i s a
xiyombela	S i j O m b E l a
xizulu	S i z u l u
xo	S O
xoka	S O k a
xolexo	S O l E S O
xona	S O n a
xongile	S O N g i l E
xongisa	S O N g i s a
xopaxop	S O p a S O p
xopaxopiwa	S O p a S O p i w a
xopaxopiwaka	S O p a S O p i w a k a
xopaxopiweke	S O p a S O p i w E k E
xopaxopiwile	S O p a S O p i w i l E
xosaseka	S O s a s E k a
xota	S O t_> a
xoxe	S O S E
xuma	S u m a
xurhisa	S u rh\ i s a
xurhisile	S u rh\ i s i l E
xuxiwa	S u S i w a
y	w a
ya	j a
yaafrika	j a a f r i k a
yaafrikadzonga	j a a f r i k a dz` O N g a
yaamerika	j a a m E r i k a
yaba	j a b a
yafilimu	j a f i l i m u
yahi	j a h\ i
yaka	j a k a
yakona	j a k O n a
yaku	j a k u
yakumeka	j a k u m E k a
yakunandzika	j a k u n a n' dz` i k a
yalava	j a l a B a
yale	j a l E
yalekamalamulele	j a l E k a m a l a m u l E l E
yalekaya	j a l E k a j a
yaleshawela	j a l E S a w E l a
yamajaha	j a m a d_0Z a h\ a
yamandela	j a m a n d E l a
yamanya	j a m a J a
yamatimu	j a m a t_> i m u
yamisana	j a m i s a n a
yamisava	j a m i s a B a
yana	j a n a
yanawu	j a n a w u
yandheya	j a n dh\ E j a
yandzavuko	j a n' dz` a B u k O
yanga	j a N g a
yangi	j a N g i
yanhova	j a n_h O B a
yani	j a n i
yantlangu	j a n tl_> a N g u
yanwani	j a n w a n i
yapfaleriwe	j a p f a l E r i w E
yarhandziwa	j a rh\ a n' dz` i w a
yasukela	j a s u k E l a
yata	j a t_> a
yatashintfu	j a t_> a S i n t_> f u
yatatimale	j a t_> a t_> i m a l E
yatiko	j a t_> i k O
yatimale	j a t_> i m a l E
yatintombi	j a t_> i n t_> O m b i
yatirhaku	j a t_> i rh\ a k u
yatsakisa	j a tS_> a k i s a
yatsariwe	j a tS_> a r i w E
yatumbulaka	j a t_> u m b u l a k a
yavalavula	j a B a l a B u l a
yavangiwa	j a B a N g i w a
yavona	j a B O n a
yaxi	j a S i
yelana	j E l a n a
yelanaka	j E l a n a k a
yelani	j E l a n i
yelanisa	j E l a n i s a
yeleyo	j E l E j O
yemna	j E m n a
yena	j E n a
yengiwe	j E N g i w E
yeriwa	j E r i w a
yesindebele	j E s i n d E b E l E
yesu	j E s u
yexe	j E S E
yhuga	j h\ u g a
yi	j i
yibyi	j i bj i
yihi	j i h\ i
yihlumile	j i K u m i l E
yikatsa	j i k a tS_> a
yikona	j i k O n a
yikulu	j i k u l u
yikumeka	j i k u m E k a
yila	j i l a
yilava	j i l a B a
yilawula	j i l a w u l a
yile	j i l E
yilehile	j i l E h\ i l E
yima	j i m a
yimba	j i m b a
yimbela	j i m b E l a
yimbelela	j i m b E l E l a
yimbeleli	j i m b E l E l i
yimbile	j i m b i l E
yimbirhi	j i m b i rh\ i
yimbisa	j i m b i s a
yimbisi	j i m b i s i
yimbisiwa	j i m b i s i w a
yime	j i m E
yimela	j i m E l a
yimeleke	j i m E l E k E
yimi	j i m i
yimisa	j i m i s a
yimisiwa	j i m i s i w a
yimisiwe	j i m i s i w E
yimisiwile	j i m i s i w i l E
yin	j i n
yina	j i n a
yinaikonomy	j i n a i k O n O m
yinandzawulo	j i n a n' dz` a w u l O
yinaswihharhi	j i n a s` i h\ h\ a rh\ i
yinavatjini	j i n a B a t_> d_0Z i n i
yindlela	j i n dK E l a
yindlo	j i n dK O
yindlu	j i n dK u
yinga	j i N g a
yingase	j i N g a s E
yinge	j i N g E
yingenisela	j i N g E n i s E l a
yingisa	j i N g i s a
yingisela	j i N g i s E l a
yingiselela	j i N g i s E l E l a
yingisile	j i N g i s i l E
yingwani	j i N g w a n i
yingwe	j i N g w E
yini	j i n i
yintshwa	j i n tS_h w a
yinuwerile	j i n u w E r i l E
yinwana	j i n w a n a
yinwani	j i n w a n i
yinwe	j i n w E
yipfuna	j i p f u n a
yirhandza	j i rh\ a n' dz` a
yirhurhela	j i rh\ u rh\ E l a
yiri	j i r i
yisa	j i s a
yishavisa	j i S a B i s a
yishavisiwa	j i S a B i s i w a
yisiwa	j i s i w a
yita	j i t_> a
yitana	j i t_> a n a
yitele	j i t_> E l E
yitirhisana	j i t_> i rh\ i s a n a
yitlangiwa	j i tl_> a N g i w a
yitlhela	j i tl_h E l a
yiva	j i B a
yivanga	j i B a N g a
yiveriwa	j i B E r i w a
yivona	j i B O n a
yivulavula	j i B u l a B u l a
yivumbiwe	j i B u m b i w E
yiwa	j i w a
yiwi	j i w i
yiya	j i j a
yo	j O
yoanswa	j O a n s` a
yohlawuleka	j O K a w u l E k a
yokala	j O k a l a
yokukhulisa	j O k u k_h u l i s a
yolehha	j O l E h\ h\ a
yoleyo	j O l E j O
yoloye	j O l O j E
yombala	j O m b a l a
yona	j O n a
york	j O k
york	j O r k
yotala	j O t_> a l a
yotlala	j O tl_> a l a
yova	j O B a
yoxaviwa	j O S a B i w a
yoya	j O j a
yti	j t_> i
zambhala	z a m b a l a
zilambilu	z i l a m b i l u
zwane	z w a n E
